CAAGCGAAACCACTCGAAG->AAGCGAAACCACTCGAAGG
CTCGTCGCCGTAGGCAGCT->TCGTCGCCGTAGGCAGCTG
GCGGGAGTGTTAGCATAGC->CGGGAGTGTTAGCATAGCC
AGCTGTGGCATTTTAATTT->GCTGTGGCATTTTAATTTA
GTTAACTAACTCGTCGCCG->TTAACTAACTCGTCGCCGT
CCCTCTCGGCATTGAGACT->CCTCTCGGCATTGAGACTA
TTGCGCTCTTGTATACTGT->TGCGCTCTTGTATACTGTG
GCTCGAGAACTCACGAGTC->CTCGAGAACTCACGAGTCT
CTAACACACGGATTGAGGC->TAACACACGGATTGAGGCA
GTGTCGCGCAAGCCAGAAC->TGTCGCGCAAGCCAGAACA
AAGTCTATCAAACAATTAG->AGTCTATCAAACAATTAGG
CGAAGTCGGCAGAGCGTAT->GAAGTCGGCAGAGCGTATT
CTTTTGTACGCTACAGGGC->TTTTGTACGCTACAGGGCG
CCATAGATATTGATCGTGC->CATAGATATTGATCGTGCA
ATGCGTGGTCTTGCGCTCT->TGCGTGGTCTTGCGCTCTT
CCGAGACCACTCTGCAGCA->CGAGACCACTCTGCAGCAT
TCGACTCGCATTCTGCTCG->CGACTCGCATTCTGCTCGT
TCGCGCAAGCCAGAACAAA->CGCGCAAGCCAGAACAAAG
TTGTCCCTTTGGTAACCTT->TGTCCCTTTGGTAACCTTC
GTTTCGCCTCTCAAATGTA->TTTCGCCTCTCAAATGTAT
GCCCCAGCGCGTCGATGGA->CCCCAGCGCGTCGATGGAC
TAAAGAGTGGAAAAGAGGG->AAAGAGTGGAAAAGAGGGA
GCAGCATAACCCTGCTGCT->CAGCATAACCCTGCTGCTT
CTTGTATACTGTGTCGCGC->TTGTATACTGTGTCGCGCA
ATACGATGACTGCTGGAAT->TACGATGACTGCTGGAATC
AATATATATGCCTACTCCT->ATATATATGCCTACTCCTT
CAAGCCAGAACAAAGCCCG->AAGCCAGAACAAAGCCCGC
GGGTACAAACCGAGACCAC->GGTACAAACCGAGACCACT
CCGACCGTGCTACCCCATT->CGACCGTGCTACCCCATTA
GCTGTGGCATTTTAAAGCG->CTGTGGCATTTTAAAGCGA
CCGCCATGAGCTTGATTCC->CGCCATGAGCTTGATTCCA
GTCTTGGACGACGGATCGC->TCTTGGACGACGGATCGCC
ATGGACATTGTAGGGAGTC->TGGACATTGTAGGGAGTCA
AGGCATACGCCCCAGCGCG->GGCATACGCCCCAGCGCGT
GAGTAAGAATACTTGTTAA->AGTAAGAATACTTGTTAAC
CTGCTTCGTTGTGGGCTTT->TGCTTCGTTGTGGGCTTTT
TTGAATTCCTCGTTCAACT->TGAATTCCTCGTTCAACTA
GGCATTTTAAAGGAGCAAG->GCATTTTAAAGGAGCAAGT
CTTAGGCAGGTCGGAATAC->TTAGGCAGGTCGGAATACC
AAGGCTCCTCAGGCTGCGC->AGGCTCCTCAGGCTGCGCC
AGACTATAGACTTCGTGTC->GACTATAGACTTCGTGTCC
CTCGTCAGTTCCATAGATA->TCGTCAGTTCCATAGATAT
GTTCGTTCTCTTAGGCAGG->TTCGTTCTCTTAGGCAGGT
ACCGACCGTGCTACCCCAT->CCGACCGTGCTACCCCATT
TTAGGCAGGTCGGAATACC->TAGGCAGGTCGGAATACCG
GGTAATTATTGTCCCTTTG->GTAATTATTGTCCCTTTGG
GCTGTGGCATTTTAAGTGG->CTGTGGCATTTTAAGTGGG
CGTTTCGCCTCTCAAATGT->GTTTCGCCTCTCAAATGTA
GACTCGTCAGTTCCATAGA->ACTCGTCAGTTCCATAGAT
TTCTACTACCATTTCGCAA->TCTACTACCATTTCGCAAA
ACAGTGCGCCGTCTCGATG->CAGTGCGCCGTCTCGATGC
ATACTTGTTAACTAACGAT->TACTTGTTAACTAACGATG
TGCCCATCGCTGAGGAATA->GCCCATCGCTGAGGAATAC
CATCGGGCGTTGCCTGAAT->ATCGGGCGTTGCCTGAATC
TAACCTTCGATGCTGTATA->AACCTTCGATGCTGTATAA
TGATCTCCTGGGTGCGTAA->GATCTCCTGGGTGCGTAAT
GGCATTTTAATTTAGCCAT->GCATTTTAATTTAGCCATA
ATTGTCTGCCGCATTCAGC->TTGTCTGCCGCATTCAGCG
ACCATTTCGCAAAGGGTGA->CCATTTCGCAAAGGGTGAT
TTGCCCTCACAGTGCGCCG->TGCCCTCACAGTGCGCCGT
ACCGCCAGCATCGGGCGTT->CCGCCAGCATCGGGCGTTG
CGGCATCATCATTTCTTAG->GGCATCATCATTTCTTAGA
GGAATATATATGCCTACTC->GAATATATATGCCTACTCC
ACCGAGCCGTATTGAGTTG->CCGAGCCGTATTGAGTTGT
AAAGAGTGGAAAAGAGGGA->AAGAGTGGAAAAGAGGGAG
GGAAAAGAGGGAGATCTAG->GAAAAGAGGGAGATCTAGC
CAGTGCGCCGTCTCGATGC->AGTGCGCCGTCTCGATGCA
ACCACTCGAAGGCGAGTCG->CCACTCGAAGGCGAGTCGT
CTGAATTGTCTGCCGCATT->TGAATTGTCTGCCGCATTC
TTTGCTCCCCTCGGGCATA->TTGCTCCCCTCGGGCATAG
CTGCAGCATAACCCTGCTG->TGCAGCATAACCCTGCTGC
TAAAGGAGCAAGTCAATTA->AAAGGAGCAAGTCAATTAC
TCGTCGACTCGCATTCTGC->CGTCGACTCGCATTCTGCT
GAGGGAGATCTAGCATGTC->AGGGAGATCTAGCATGTCC
CTAACTCGTCGCCGTAGGC->TAACTCGTCGCCGTAGGCA
CCATCCCTCTCGGCATTGA->CATCCCTCTCGGCATTGAG
TTGTAGGGAGTCAACGAGT->TGTAGGGAGTCAACGAGTG
TGACAGATTTCATTCATCT->GACAGATTTCATTCATCTG
CCGTTTGTACCTCGCTTTA->CGTTTGTACCTCGCTTTAT
TTGATCTCCTGGGTGCGTA->TGATCTCCTGGGTGCGTAA
ACCCTGCTGCTTCGTTGTG->CCCTGCTGCTTCGTTGTGG
ATCTGTCGAAGTCGGCAGA->TCTGTCGAAGTCGGCAGAG
ACACCCCGTCCGCAGACAC->CACCCCGTCCGCAGACACG
CAACACAAGTGTTGCACCC->AACACAAGTGTTGCACCCT
GAATACTTGTTAACTAACG->AATACTTGTTAACTAACGA
TCGTTCAACTATACGATGA->CGTTCAACTATACGATGAC
AGACTAACATACTAAAGTG->GACTAACATACTAAAGTGG
GCCCGACCATCCCTCTCGG->CCCGACCATCCCTCTCGGC
TAATGAAAAATGACGAGGC->AATGAAAAATGACGAGGCG
CCTCTCAAATGTATTGATC->CTCTCAAATGTATTGATCT
CTTGTTAACTAACCTCGAC->TTGTTAACTAACCTCGACG
GCCAGAAGAACAACGTTCG->CCAGAAGAACAACGTTCGA
GTTGCCTGAATCTTTGCTC->TTGCCTGAATCTTTGCTCC
TCGAAGTCGGCAGAGCGTA->CGAAGTCGGCAGAGCGTAT
GTACATTTGCCGAGTGTGA->TACATTTGCCGAGTGTGAG
TATTGAGTTGTGCTGCAAA->ATTGAGTTGTGCTGCAAAC
AATTCCTCGTTCAACTATA->ATTCCTCGTTCAACTATAC
CCTCTCGGCATTGAGACTA->CTCTCGGCATTGAGACTAT
TAGCATAGCCGGGGGATTT->AGCATAGCCGGGGGATTTG
GTCGCGCAAGCCAGAACAA->TCGCGCAAGCCAGAACAAA
TGTCGCGCAAGCCAGAACA->GTCGCGCAAGCCAGAACAA
ATAAGTACGTTCCAAGCCC->TAAGTACGTTCCAAGCCCC
CTCTCCACCGAGCCGTATT->TCTCCACCGAGCCGTATTG
GTAAGTCTATCAAACAATT->TAAGTCTATCAAACAATTA
GACTCGCATTCTGCTCGTA->ACTCGCATTCTGCTCGTAT
GAGCACTACAGCATTAGCA->AGCACTACAGCATTAGCAC
CACGATACGGTAAGTCTAT->ACGATACGGTAAGTCTATC
GCCCCCGGCGTTGGGTATG->CCCCCGGCGTTGGGTATGC
TACCATTTCGCAAAGGGTG->ACCATTTCGCAAAGGGTGA
AGCCGGGGGATTTGAAGGG->GCCGGGGGATTTGAAGGGT
TCATTCATCTGCTCGATCG->CATTCATCTGCTCGATCGT
GCCTACTCCTTTTGTACGC->CCTACTCCTTTTGTACGCT
CATTCATCTGCTCGATCGT->ATTCATCTGCTCGATCGTT
GGTCGCTGGAAGGAGCTAG->GTCGCTGGAAGGAGCTAGC
GTGGTCTTTACTTCGGTTG->TGGTCTTTACTTCGGTTGC
GAAGGGTCGCTGGAAGGAG->AAGGGTCGCTGGAAGGAGC
TCTAGCATGTCCATCCTAC->CTAGCATGTCCATCCTACG
ATTGATCTCCTGGGTGCGT->TTGATCTCCTGGGTGCGTA
CAGCTGTGGCATTTTAAAG->AGCTGTGGCATTTTAAAGG,AGCTGTGGCATTTTAAAGC
GGTACATTTGCCGAGTGTG->GTACATTTGCCGAGTGTGA
CCGCGAGTTAGCCGAATTG->CGCGAGTTAGCCGAATTGT
GCAGCTGTGGCATTTTAAA->CAGCTGTGGCATTTTAAAG,CAGCTGTGGCATTTTAAAG
GGACATAGTGTGGTGCCAA->GACATAGTGTGGTGCCAAA
TCTTTGCTCCCCTCGGGCA->CTTTGCTCCCCTCGGGCAT
GCGCAGAGTTCGAACCGGT->CGCAGAGTTCGAACCGGTA
TCTTAGGCAGGTCGGAATA->CTTAGGCAGGTCGGAATAC
GCGCAAGCCAGAACAAAGC->CGCAAGCCAGAACAAAGCC
CTGGGTGCGTAATTGAGGA->TGGGTGCGTAATTGAGGAC
CCTTGCAACACAAGTGTTG->CTTGCAACACAAGTGTTGC
CTCCACCGAGCCGTATTGA->TCCACCGAGCCGTATTGAG
GTTCGTGTGCCGTAGTAGT->TTCGTGTGCCGTAGTAGTG
GACATTGTAGGGAGTCAAC->ACATTGTAGGGAGTCAACG
ACAGCCAGGGGTGCATCAA->CAGCCAGGGGTGCATCAAC
ATAACCCTGCTGCTTCGTT->TAACCCTGCTGCTTCGTTG
AATAATGAAAAATGACGAG->ATAATGAAAAATGACGAGG
ACTAACGATGCAGCAGCGG->CTAACGATGCAGCAGCGGC
ATCGTTTCGCCTCTCAAAT->TCGTTTCGCCTCTCAAATG
ACTCGAAGGCGAGTCGTCC->CTCGAAGGCGAGTCGTCCA
AGTTGCTGCGCAGAGTTCG->GTTGCTGCGCAGAGTTCGA
TGCATCATCACTCATGGCC->GCATCATCACTCATGGCCT
CGGAATACCGCCAGCATCG->GGAATACCGCCAGCATCGG
CTTCGTGTCCTTGCAACAC->TTCGTGTCCTTGCAACACA
CGAGTCGTCCATGGCCTGA->GAGTCGTCCATGGCCTGAA
GCCAAAGCGTACCTGTGGT->CCAAAGCGTACCTGTGGTT
GAACCCCCCGTGGTCTTTA->AACCCCCCGTGGTCTTTAC
CTGCTGGAATCCTGCATAT->TGCTGGAATCCTGCATATG
TTAAAGGAGCAAGTCAATT->TAAAGGAGCAAGTCAATTA
CGGTAAGTCTATCAAACAA->GGTAAGTCTATCAAACAAT
CTGGAGGACATTTAGTCTC->TGGAGGACATTTAGTCTCG
CCGACCGCATTTGAATTCC->CGACCGCATTTGAATTCCT
TCGGCTTGACAGATTTCAT->CGGCTTGACAGATTTCATT
TTGTATACTGTGTCGCGCA->TGTATACTGTGTCGCGCAA
GCTGGAAGGAGCTAGCACG->CTGGAAGGAGCTAGCACGA
AGAGCGTATTTGCAGTAAG->GAGCGTATTTGCAGTAAGA
TAAGGCAGCTGTGGCATTT->AAGGCAGCTGTGGCATTTT
CGTTCAACTATACGATGAC->GTTCAACTATACGATGACT
CGTATTGAGTTGTGCTGCA->GTATTGAGTTGTGCTGCAA
CTCCTGGGTGCGTAATTGA->TCCTGGGTGCGTAATTGAG
ACTACAGCATTAGCACTCG->CTACAGCATTAGCACTCGC
AGGCAGCTGTGGCATTTTA->GGCAGCTGTGGCATTTTAA,GGCAGCTGTGGCATTTTAA,GGCAGCTGTGGCATTTTAA
TCCGCCATGAGCTTGATTC->CCGCCATGAGCTTGATTCC
ACGGATTGAGGCAGCTGTG->CGGATTGAGGCAGCTGTGG
TCAGCGGCGTCCGCGAGTT->CAGCGGCGTCCGCGAGTTA
ACATGCCCATCGCTGAGGA->CATGCCCATCGCTGAGGAA
CAAGTGTTGCACCCTAACC->AAGTGTTGCACCCTAACCT
GCGACTCGTCAGTTCCATA->CGACTCGTCAGTTCCATAG
CACTCGAAGGCGAGTCGTC->ACTCGAAGGCGAGTCGTCC
CGCAGACACGTCGCCCTCC->GCAGACACGTCGCCCTCCT
TGGCATTTTAAAGCGACTC->GGCATTTTAAAGCGACTCG
CTCGGCATTGAGACTATAG->TCGGCATTGAGACTATAGA
CCGAGTGTGAGTAAGAATA->CGAGTGTGAGTAAGAATAC
TGGGCTTTTATTTCTGAAT->GGGCTTTTATTTCTGAATT
TCTGCTCGATCGTTTCGCC->CTGCTCGATCGTTTCGCCT
CAGCTGTGGCATTTTAATT->AGCTGTGGCATTTTAATTT
CGCAGAACTGAGTAAACAG->GCAGAACTGAGTAAACAGG
CGACGGATCGCCGGCTCGA->GACGGATCGCCGGCTCGAG
ACACGTCGCCCTCCTACCG->CACGTCGCCCTCCTACCGA
TTGCGCGTCTGTCTCACGA->TGCGCGTCTGTCTCACGAA
TTATAAAGGGAAACGATGC->TATAAAGGGAAACGATGCG
AGTCTTGTCGGGTCTATAA->GTCTTGTCGGGTCTATAAG
TTGATCGTGCAAGGTCACA->TGATCGTGCAAGGTCACAG
CGCTCTTGTGTAAACGAAT->GCTCTTGTGTAAACGAATA
CAAGGGAACCTAATGGGAA->AAGGGAACCTAATGGGAAT
GTATATACTCAACCGTCTA->TATATACTCAACCGTCTAG
AGCTTGATTCCAATCTGTC->GCTTGATTCCAATCTGTCG
TCGATGGACATTGCATCAT->CGATGGACATTGCATCATC
AACAATTAGGAGACGGTCC->ACAATTAGGAGACGGTCCT
GATGCGTGGTCTTGCGCTC->ATGCGTGGTCTTGCGCTCT
TCAGAACCTCAAGAACCCC->CAGAACCTCAAGAACCCCC
GCTGAGGAATACTTGTTAA->CTGAGGAATACTTGTTAAC
GGCCACAAATACGGAGAAA->GCCACAAATACGGAGAAAC
TTTTAAAGCGACTCGTCAG->TTTAAAGCGACTCGTCAGT
TGTGCTGCAAACGGGTACA->GTGCTGCAAACGGGTACAA
GTCAACGAGTGGCGTACAT->TCAACGAGTGGCGTACATG
ACGCCCCAGCGCGTCGATG->CGCCCCAGCGCGTCGATGG
AATGCCGTTTGTACCTCGC->ATGCCGTTTGTACCTCGCT
CATCATCACTCATGGCCTT->ATCATCACTCATGGCCTTG
GAGGCAGTGTAGGCATACG->AGGCAGTGTAGGCATACGC
TCACAGTGCGCCGTCTCGA->CACAGTGCGCCGTCTCGAT
GTCCGCGAGTTAGCCGAAT->TCCGCGAGTTAGCCGAATT
CGCTGAGGAATACTTGTTA->GCTGAGGAATACTTGTTAA
ATACTTGTTAACTAACTCG->TACTTGTTAACTAACTCGT
CTCCTTTATCAGATATGCC->TCCTTTATCAGATATGCCC
CTGCATATGGAGGGGCGCA->TGCATATGGAGGGGCGCAG
CTACACGAGGACATAGTGT->TACACGAGGACATAGTGTG
CTGATCTATTGTAATGGGT->TGATCTATTGTAATGGGTC
GCAGCTGTGGCATTTTAAT->CAGCTGTGGCATTTTAATT
AAGTCAATTACCGTCAGAA->AGTCAATTACCGTCAGAAG
GAATGCCGTTTGTACCTCG->AATGCCGTTTGTACCTCGC
AAGAACCCCCCGTGGTCTT->AGAACCCCCCGTGGTCTTT
GTTGCTGGAGGACATTTAG->TTGCTGGAGGACATTTAGT
GTCCCTTTGGTAACCTTCG->TCCCTTTGGTAACCTTCGA
CCTCAAGAACCCCCCGTGG->CTCAAGAACCCCCCGTGGT
GATAACGGCAGACTAACAT->ATAACGGCAGACTAACATA
CCTGTTAGTTGCTGCGCAG->CTGTTAGTTGCTGCGCAGA
GCATTGCCGTCCCGACCGC->CATTGCCGTCCCGACCGCA
AGCGGCAGCTGTGGCATTT->GCGGCAGCTGTGGCATTTT
GAGTTGTGCTGCAAACGGG->AGTTGTGCTGCAAACGGGT
AACTGAGTAAACAGGATGG->ACTGAGTAAACAGGATGGC
TCGTTCTCTTAGGCAGGTC->CGTTCTCTTAGGCAGGTCG
GGTAACCTTCGATGCTGTA->GTAACCTTCGATGCTGTAT
GATGCTGTATAAAGAGTGG->ATGCTGTATAAAGAGTGGA
CTCACAGTGCGCCGTCTCG->TCACAGTGCGCCGTCTCGA
GTCGGGTCTATAAGTACGT->TCGGGTCTATAAGTACGTT
TCTCCGAGTCAGCTATTCA->CTCCGAGTCAGCTATTCAT
TCGACCGCAGAACTGAGTA->CGACCGCAGAACTGAGTAA
GGTAAGTCTATCAAACAAT->GTAAGTCTATCAAACAATT
GGAGGACATTTAGTCTCGA->GAGGACATTTAGTCTCGAC
GAGTCAGCTATTCATGAAT->AGTCAGCTATTCATGAATA
CGCGCAAGCCAGAACAAAG->GCGCAAGCCAGAACAAAGC
GCTTGATTCCAATCTGTCG->CTTGATTCCAATCTGTCGA
TCTCGACCGCAGAACTGAG->CTCGACCGCAGAACTGAGT
GAATACTTGTTAACTAACT->AATACTTGTTAACTAACTC
CATCCTACGCCCTCTCCAC->ATCCTACGCCCTCTCCACC
TTCGAACCGGTACATTTGC->TCGAACCGGTACATTTGCC
CGTACATGCCCATCGCTGA->GTACATGCCCATCGCTGAG
TCGTGTGCCGTAGTAGTGG->CGTGTGCCGTAGTAGTGGA
CTAGCATGTCCATCCTACG->TAGCATGTCCATCCTACGC
ACTCCTTTTGTACGCTACA->CTCCTTTTGTACGCTACAG
GTATGCGTTGCGCGTCTGT->TATGCGTTGCGCGTCTGTC
ATCGGCATCATCATTTCTT->TCGGCATCATCATTTCTTA
GCATCATCATTTCTTAGAT->CATCATCATTTCTTAGATC
GGCATCATCATTTCTTAGA->GCATCATCATTTCTTAGAT
CTTCGTTGTGGGCTTTTAT->TTCGTTGTGGGCTTTTATT
CAGAAAGAGGCAGTGTAGG->AGAAAGAGGCAGTGTAGGC
TGCAAGGTCACAGCCAGGG->GCAAGGTCACAGCCAGGGG
TGTTCCATGGAAGTCCTTA->GTTCCATGGAAGTCCTTAA
TAAGATTATTACCGACCGT->AAGATTATTACCGACCGTG
AAGTCTCCTTTATCAGATA->AGTCTCCTTTATCAGATAT
GTCGCCCTCCTACCGAGCT->TCGCCCTCCTACCGAGCTA
AAGAGGGAGATCTAGCATG->AGAGGGAGATCTAGCATGT
AGCCCGCCCCCGGCGTTGG->GCCCGCCCCCGGCGTTGGG
TTCGTGTCCTTGCAACACA->TCGTGTCCTTGCAACACAA
TCCCGACCGCATTTGAATT->CCCGACCGCATTTGAATTC
ATTTTAAAGGAGCAAGTCA->TTTTAAAGGAGCAAGTCAA
GGCCTGAACACGAAGACCT->GCCTGAACACGAAGACCTA
GCTGGAATCCTGCATATGG->CTGGAATCCTGCATATGGA
GCCCTCCTACCGAGCTAAG->CCCTCCTACCGAGCTAAGT
AACAACGTTCGATCAGAAA->ACAACGTTCGATCAGAAAG
AGGAGACGGTCCTGATCTA->GGAGACGGTCCTGATCTAT
CCGTCTCGATGCATCTGTT->CGTCTCGATGCATCTGTTC
TCTGTTCCATGGAAGTCCT->CTGTTCCATGGAAGTCCTT
CGTCCCGACCGCATTTGAA->GTCCCGACCGCATTTGAAT
GGCAGGTCGGAATACCGCC->GCAGGTCGGAATACCGCCA
AGAAAGAGGCAGTGTAGGC->GAAAGAGGCAGTGTAGGCA
GGGAGCACTACAGCATTAG->GGAGCACTACAGCATTAGC
CCTCGGGCATAGCAGGATT->CTCGGGCATAGCAGGATTC
GATTTGAAGGGTCGCTGGA->ATTTGAAGGGTCGCTGGAA
CATTTTAAGTGGGAGCACT->ATTTTAAGTGGGAGCACTA
TTAGGAGACGGTCCTGATC->TAGGAGACGGTCCTGATCT
GAGTGTGAGTAAGAATACT->AGTGTGAGTAAGAATACTT
GGCCGCCTGAATGCCGTTT->GCCGCCTGAATGCCGTTTG
TGGAAGTCCTTAATCCAAA->GGAAGTCCTTAATCCAAAA
CTTGTTAACTAACACACGG->TTGTTAACTAACACACGGA
TAGTTGCTGCGCAGAGTTC->AGTTGCTGCGCAGAGTTCG
CGCTGGAAGGAGCTAGCAC->GCTGGAAGGAGCTAGCACG
GAACTCACGAGTCTACATT->AACTCACGAGTCTACATTG
CAACGTTCGATCAGAAAGA->AACGTTCGATCAGAAAGAG
ATGGAGGGGCGCAGTGTGC->TGGAGGGGCGCAGTGTGCT
AATACTTGTTAACTAACCT->ATACTTGTTAACTAACCTC
CGCACGCTCTTGTGTAAAC->GCACGCTCTTGTGTAAACG
AACGAATACTTGTTAACTA->ACGAATACTTGTTAACTAA
CCCCAGCGCGTCGATGGAC->CCCAGCGCGTCGATGGACA
AAGAGGCAGTGTAGGCATA->AGAGGCAGTGTAGGCATAC
AACCTCGACGCTAAGGCAG->ACCTCGACGCTAAGGCAGC
GGCTATATACAAAGTATCT->GCTATATACAAAGTATCTT
TTCATGAATACTTGTTAAC->TCATGAATACTTGTTAACT
TCGTCAGTTCCATAGATAT->CGTCAGTTCCATAGATATT
ACGAAGACCTACACGAGGA->CGAAGACCTACACGAGGAC
CCCAGCGCGTCGATGGACA->CCAGCGCGTCGATGGACAT
TCTATTGTAATGGGTCAGA->CTATTGTAATGGGTCAGAT
CTTTACTTCGGTTGCTGGA->TTTACTTCGGTTGCTGGAG
CATTGCATCATCACTCATG->ATTGCATCATCACTCATGG
TTGTAATGGGTCAGATTGC->TGTAATGGGTCAGATTGCT
TGGGTGCGTAATTGAGGAC->GGGTGCGTAATTGAGGACT
TTTTAAAGGAGCAAGTCAA->TTTAAAGGAGCAAGTCAAT
CAAACGATAACGGCAGACT->AAACGATAACGGCAGACTA
GATTATTACCGACCGTGCT->ATTATTACCGACCGTGCTA
AACCACTCGAAGGCGAGTC->ACCACTCGAAGGCGAGTCG
CGACTCGCATTCTGCTCGT->GACTCGCATTCTGCTCGTA
TGTCTTAGCATTGCCGTCC->GTCTTAGCATTGCCGTCCC
CAGCTGTGGCATTTTAAGT->AGCTGTGGCATTTTAAGTG
GAGAACTCACGAGTCTACA->AGAACTCACGAGTCTACAT
TCCGCGAGTTAGCCGAATT->CCGCGAGTTAGCCGAATTG
GGACGACGGATCGCCGGCT->GACGACGGATCGCCGGCTC
GGGTCAGATTGCTTATTAT->GGTCAGATTGCTTATTATA
TCCATAGATATTGATCGTG->CCATAGATATTGATCGTGC
ACCTTGTAGTGTCTTAGCA->CCTTGTAGTGTCTTAGCAT
GGAGCTAGCACGATACGGT->GAGCTAGCACGATACGGTA
CTACTCCTTTTGTACGCTA->TACTCCTTTTGTACGCTAC
AGCATAGCCGGGGGATTTG->GCATAGCCGGGGGATTTGA
CTCGCTTTATAAAGGGAAA->TCGCTTTATAAAGGGAAAC
CATGCCCATCGCTGAGGAA->ATGCCCATCGCTGAGGAAT
GTCCGCCATGAGCTTGATT->TCCGCCATGAGCTTGATTC
CGACGCTAAGGCAGCTGTG->GACGCTAAGGCAGCTGTGG
TCCAAGCCCCCGTATCGGC->CCAAGCCCCCGTATCGGCA
CTGCCGCATTCAGCGGCGT->TGCCGCATTCAGCGGCGTC
TCAGAAGGCTCCTCAGGCT->CAGAAGGCTCCTCAGGCTG
AGCTGTGGCATTTTAAAGC->GCTGTGGCATTTTAAAGCG
AAACCCTGTAGCACAAACG->AACCCTGTAGCACAAACGA
TGCGCGTCTGTCTCACGAA->GCGCGTCTGTCTCACGAAC
TAATTATTGTCCCTTTGGT->AATTATTGTCCCTTTGGTA
GGAATACCGCCAGCATCGG->GAATACCGCCAGCATCGGG
GGATTCGGCTTGACAGATT->GATTCGGCTTGACAGATTT
TTTATAAAGGGAAACGATG->TTATAAAGGGAAACGATGC
GTATTTGCAGTAAGATTAT->TATTTGCAGTAAGATTATT
GATTCGGCTTGACAGATTT->ATTCGGCTTGACAGATTTC
GAGGACATTTAGTCTCGAC->AGGACATTTAGTCTCGACC
CTAAGTCTCCTTTATCAGA->TAAGTCTCCTTTATCAGAT
ATCAGATATGCCCGACCAT->TCAGATATGCCCGACCATC
GTCGCCGTAGGCAGCTGTG->TCGCCGTAGGCAGCTGTGG
TCGTGCAAGGTCACAGCCA->CGTGCAAGGTCACAGCCAG
AGTCTCCTTTATCAGATAT->GTCTCCTTTATCAGATATG
CGGGAGTGTTAGCATAGCC->GGGAGTGTTAGCATAGCCG
CGTTGCGCGTCTGTCTCAC->GTTGCGCGTCTGTCTCACG
ATTTGCCGAGTGTGAGTAA->TTTGCCGAGTGTGAGTAAG
TTATGGAATGTAGGGTCCG->TATGGAATGTAGGGTCCGC
TTAGATCTTTATGTTCGTG->TAGATCTTTATGTTCGTGT
CTTTCTACTACCATTTCGC->TTTCTACTACCATTTCGCA
TGTATAAAGAGTGGAAAAG->GTATAAAGAGTGGAAAAGA
TGAAGGGTCGCTGGAAGGA->GAAGGGTCGCTGGAAGGAG
TCTCAAATGTATTGATCTC->CTCAAATGTATTGATCTCC
GGCAGACTAACATACTAAA->GCAGACTAACATACTAAAG
ATTGTAATGGGTCAGATTG->TTGTAATGGGTCAGATTGC
TCGCATTCTGCTCGTATAT->CGCATTCTGCTCGTATATA
GATCGTGCAAGGTCACAGC->ATCGTGCAAGGTCACAGCC
TATTACCGACCGTGCTACC->ATTACCGACCGTGCTACCC
CCCCCGTATCGGCATCATC->CCCCGTATCGGCATCATCA
TAGGCATACGCCCCAGCGC->AGGCATACGCCCCAGCGCG
GTGTCTTAGCATTGCCGTC->TGTCTTAGCATTGCCGTCC
TTAGTCTCGACCGCAGAAC->TAGTCTCGACCGCAGAACT
GCGTGTATCAAGGGAACCT->CGTGTATCAAGGGAACCTA
GGGGTGCATCAACAGTCTT->GGGTGCATCAACAGTCTTG
TCCTGGGTGCGTAATTGAG->CCTGGGTGCGTAATTGAGG
TTTATCAGATATGCCCGAC->TTATCAGATATGCCCGACC
TTCAACTATACGATGACTG->TCAACTATACGATGACTGC
AGCCAGAAGAACAACGTTC->GCCAGAAGAACAACGTTCG
ACTTGTTAACTAACTCGTC->CTTGTTAACTAACTCGTCG
GTCTAGTCTTGGACGACGG->TCTAGTCTTGGACGACGGA
CTGTGGCATTTTAAGTGGG->TGTGGCATTTTAAGTGGGA
GCCTGAATGCCGTTTGTAC->CCTGAATGCCGTTTGTACC
GAGACGGTCCTGATCTATT->AGACGGTCCTGATCTATTG
CTAACCTGTTAGTTGCTGC->TAACCTGTTAGTTGCTGCG
GGGTATGCGTTGCGCGTCT->GGTATGCGTTGCGCGTCTG
AACGAGTGGCGTACATGCC->ACGAGTGGCGTACATGCCC
ACAAACCGAGACCACTCTG->CAAACCGAGACCACTCTGC
TTAAACCCGTCTGGCCTTG->TAAACCCGTCTGGCCTTGC
TGCGCTCTTGTATACTGTG->GCGCTCTTGTATACTGTGT
GTGGCATTTTAAAGGAGCA->TGGCATTTTAAAGGAGCAA
ATGGCCTGAACACGAAGAC->TGGCCTGAACACGAAGACC
TCCTTGCAACACAAGTGTT->CCTTGCAACACAAGTGTTG
ACCTTCGATGCTGTATAAA->CCTTCGATGCTGTATAAAG
TGCAGCAGCGGCAGCTGTG->GCAGCAGCGGCAGCTGTGG
GAGTGGCGTACATGCCCAT->AGTGGCGTACATGCCCATC
TTAGCATAGCCGGGGGATT->TAGCATAGCCGGGGGATTT
AAGTGGCCGCCTGAATGCC->AGTGGCCGCCTGAATGCCG
ACTCGCGGGAGTGTTAGCA->CTCGCGGGAGTGTTAGCAT
CCGTCAGAAGGCTCCTCAG->CGTCAGAAGGCTCCTCAGG
TACTTGTTAACTAACACAC->ACTTGTTAACTAACACACG
ATAGACTTCGTGTCCTTGC->TAGACTTCGTGTCCTTGCA
GCATACGCCCCAGCGCGTC->CATACGCCCCAGCGCGTCG
TTGAGTCGTCGACTCGCAT->TGAGTCGTCGACTCGCATT
TGCCTACTCCTTTTGTACG->GCCTACTCCTTTTGTACGC
TTATTTCTGAATTGTCTGC->TATTTCTGAATTGTCTGCC
TTCTCTTAGGCAGGTCGGA->TCTCTTAGGCAGGTCGGAA
TCCTACCGAGCTAAGTCTC->CCTACCGAGCTAAGTCTCC
CGATGGACATTGCATCATC->GATGGACATTGCATCATCA
ACACGGATTGAGGCAGCTG->CACGGATTGAGGCAGCTGT
TATGTTCGTGTGCCGTAGT->ATGTTCGTGTGCCGTAGTA
GTCGACTCGCATTCTGCTC->TCGACTCGCATTCTGCTCG
GCCCTCACAGTGCGCCGTC->CCCTCACAGTGCGCCGTCT
GTTGCTGCGCAGAGTTCGA->TTGCTGCGCAGAGTTCGAA
CGAACCGGTACATTTGCCG->GAACCGGTACATTTGCCGA
CTTTTATTTCTGAATTGTC->TTTTATTTCTGAATTGTCT
CGCGTCGATGGACATTGCA->GCGTCGATGGACATTGCAT
TCTTCGGCCACAAATACGG->CTTCGGCCACAAATACGGA
AACATACTAAAGTGGCCGC->ACATACTAAAGTGGCCGCC
TCGGGCATAGCAGGATTCG->CGGGCATAGCAGGATTCGG
GCGTCCGCGAGTTAGCCGA->CGTCCGCGAGTTAGCCGAA
TACATTTGCCGAGTGTGAG->ACATTTGCCGAGTGTGAGT
GATGCAGCAGCGGCAGCTG->ATGCAGCAGCGGCAGCTGT
CGACCGTGCTACCCCATTA->GACCGTGCTACCCCATTAA
GTGCCAAAGCGTACCTGTG->TGCCAAAGCGTACCTGTGG
AACCGTCTAGTCTTGGACG->ACCGTCTAGTCTTGGACGA
ATATTGATCGTGCAAGGTC->TATTGATCGTGCAAGGTCA
ACTACCATTTCGCAAAGGG->CTACCATTTCGCAAAGGGT
ACATACTAAAGTGGCCGCC->CATACTAAAGTGGCCGCCT
GCCAGAACAAAGCCCGCCC->CCAGAACAAAGCCCGCCCC
GCCAGCATCGGGCGTTGCC->CCAGCATCGGGCGTTGCCT
GAACCTCAAGAACCCCCCG->AACCTCAAGAACCCCCCGT
TGCAACACAAGTGTTGCAC->GCAACACAAGTGTTGCACC
ACATTTGCCGAGTGTGAGT->CATTTGCCGAGTGTGAGTA
CCTCACAGTGCGCCGTCTC->CTCACAGTGCGCCGTCTCG
CTATACGATGACTGCTGGA->TATACGATGACTGCTGGAA
GCTAGCACGATACGGTAAG->CTAGCACGATACGGTAAGT
TGGAAGGAGCTAGCACGAT->GGAAGGAGCTAGCACGATA
CTCATGGCCTTGACGGCAA->TCATGGCCTTGACGGCAAG
TGGAGGGGCGCAGTGTGCT->GGAGGGGCGCAGTGTGCTT
AGGACATAGTGTGGTGCCA->GGACATAGTGTGGTGCCAA
TGCACCCTAACCTGTTAGT->GCACCCTAACCTGTTAGTT
CATAGATATTGATCGTGCA->ATAGATATTGATCGTGCAA
TTGCTCCCCTCGGGCATAG->TGCTCCCCTCGGGCATAGC
TAAACCCGTCTGGCCTTGC->AAACCCGTCTGGCCTTGCC
GATATGCCCGACCATCCCT->ATATGCCCGACCATCCCTC
AAGGCAGCTGTGGCATTTT->AGGCAGCTGTGGCATTTTA
ACTATAGACTTCGTGTCCT->CTATAGACTTCGTGTCCTT
CTGAATCTTTGCTCCCCTC->TGAATCTTTGCTCCCCTCG
ATTGCTTATTATACAGCCA->TTGCTTATTATACAGCCAG
CGCAGTGTGCTTTCTACTA->GCAGTGTGCTTTCTACTAC
TGCTCGATCGTTTCGCCTC->GCTCGATCGTTTCGCCTCT
CGATGACTGCTGGAATCCT->GATGACTGCTGGAATCCTG
AAGCGACTCGTCAGTTCCA->AGCGACTCGTCAGTTCCAT
TGAATTGTCTGCCGCATTC->GAATTGTCTGCCGCATTCA
ATTCATGAATACTTGTTAA->TTCATGAATACTTGTTAAC
TCATGAATACTTGTTAACT->CATGAATACTTGTTAACTA
GACATTGCATCATCACTCA->ACATTGCATCATCACTCAT
CATATGGAGGGGCGCAGTG->ATATGGAGGGGCGCAGTGT
TTTGTACCTCGCTTTATAA->TTGTACCTCGCTTTATAAA
TCTGGCCTTGCCCTCACAG->CTGGCCTTGCCCTCACAGT
GATCAGAAAGAGGCAGTGT->ATCAGAAAGAGGCAGTGTA
AAAAATGACGAGGCGTGTA->AAAATGACGAGGCGTGTAT
AAAGGGTGATCAATAATGA->AAGGGTGATCAATAATGAA
GCGTATTTGCAGTAAGATT->CGTATTTGCAGTAAGATTA
GGAACCTAATGGGAATATA->GAACCTAATGGGAATATAT
GACCACTCTGCAGCATAAC->ACCACTCTGCAGCATAACC
ATGCATCTGTTCCATGGAA->TGCATCTGTTCCATGGAAG
GTTCCAAGCCCCCGTATCG->TTCCAAGCCCCCGTATCGG
GTGGGCTTTTATTTCTGAA->TGGGCTTTTATTTCTGAAT
GCCGAATTGTACCTTGTAG->CCGAATTGTACCTTGTAGT
CCGTCTAGTCTTGGACGAC->CGTCTAGTCTTGGACGACG
ATTATACAGCCAGAAGAAC->TTATACAGCCAGAAGAACA
CTTGCGCTCTTGTATACTG->TTGCGCTCTTGTATACTGT
TAGTGTCTTAGCATTGCCG->AGTGTCTTAGCATTGCCGT
AGGATTCGGCTTGACAGAT->GGATTCGGCTTGACAGATT
TGTCGAAGTCGGCAGAGCG->GTCGAAGTCGGCAGAGCGT
CCTCAGGCTGCGCCTGGTA->CTCAGGCTGCGCCTGGTAA
GCTCCTCAGGCTGCGCCTG->CTCCTCAGGCTGCGCCTGG
TAGATCTTTATGTTCGTGT->AGATCTTTATGTTCGTGTG
ACGCCGTCTCCGAGTCAGC->CGCCGTCTCCGAGTCAGCT
GCTCTTGTATACTGTGTCG->CTCTTGTATACTGTGTCGC
TATAAAGAGTGGAAAAGAG->ATAAAGAGTGGAAAAGAGG
GGCTCCTCAGGCTGCGCCT->GCTCCTCAGGCTGCGCCTG
GTAGCACAAACGATAACGG->TAGCACAAACGATAACGGC
GTATACTGTGTCGCGCAAG->TATACTGTGTCGCGCAAGC
CAAACAATTAGGAGACGGT->AAACAATTAGGAGACGGTC
CCATAACGCACGCTCTTGT->CATAACGCACGCTCTTGTG
TAAAGCGACTCGTCAGTTC->AAAGCGACTCGTCAGTTCC
ATAAAGAGTGGAAAAGAGG->TAAAGAGTGGAAAAGAGGG
GGCTCGAGAACTCACGAGT->GCTCGAGAACTCACGAGTC
ATACTGTGTCGCGCAAGCC->TACTGTGTCGCGCAAGCCA
AATTGTACCTTGTAGTGTC->ATTGTACCTTGTAGTGTCT
ATATGCCCGACCATCCCTC->TATGCCCGACCATCCCTCT
GTGTATCAAGGGAACCTAA->TGTATCAAGGGAACCTAAT
AAACAATTAGGAGACGGTC->AACAATTAGGAGACGGTCC
AGTAAACAGGATGGCATGG->GTAAACAGGATGGCATGGG
AACACGAAGACCTACACGA->ACACGAAGACCTACACGAG
AAGGGAAACGATGCGTGGT->AGGGAAACGATGCGTGGTC
TTGGGCGAATGGACATTGT->TGGGCGAATGGACATTGTA
CCCCCGGCGTTGGGTATGC->CCCCGGCGTTGGGTATGCG
TATTTGCAGTAAGATTATT->ATTTGCAGTAAGATTATTA
TTGCTTATTATACAGCCAG->TGCTTATTATACAGCCAGA
GCACAAACGATAACGGCAG->CACAAACGATAACGGCAGA
CGCCGTAGGCAGCTGTGGC->GCCGTAGGCAGCTGTGGCA
CGCCCCCGGCGTTGGGTAT->GCCCCCGGCGTTGGGTATG
ACAGCCAGAAGAACAACGT->CAGCCAGAAGAACAACGTT
TGTGCCGTAGTAGTGGAGC->GTGCCGTAGTAGTGGAGCT
TTATGTTCGTGTGCCGTAG->TATGTTCGTGTGCCGTAGT
ATGACGAGGCGTGTATCAA->TGACGAGGCGTGTATCAAG
CTGTTAGTTGCTGCGCAGA->TGTTAGTTGCTGCGCAGAG
GCTGCGCCTGGTAATTATT->CTGCGCCTGGTAATTATTG
CTATCAAACAATTAGGAGA->TATCAAACAATTAGGAGAC
TAAAGGGAAACGATGCGTG->AAAGGGAAACGATGCGTGG
ATGTATTGATCTCCTGGGT->TGTATTGATCTCCTGGGTG
TCGGCAGAGCGTATTTGCA->CGGCAGAGCGTATTTGCAG
TTACCGTCAGAAGGCTCCT->TACCGTCAGAAGGCTCCTC
GGGATTTGAAGGGTCGCTG->GGATTTGAAGGGTCGCTGG
TTTAAAGCGACTCGTCAGT->TTAAAGCGACTCGTCAGTT
TCATCATTTCTTAGATCTT->CATCATTTCTTAGATCTTT
CTCGCATTCTGCTCGTATA->TCGCATTCTGCTCGTATAT
CGTTCTCTTAGGCAGGTCG->GTTCTCTTAGGCAGGTCGG
GAGTCAACGAGTGGCGTAC->AGTCAACGAGTGGCGTACA
ATAATGAAAAATGACGAGG->TAATGAAAAATGACGAGGC
CTACGCCCTCTCCACCGAG->TACGCCCTCTCCACCGAGC
CCATGAGCTTGATTCCAAT->CATGAGCTTGATTCCAATC
CAGAAGGCTCCTCAGGCTG->AGAAGGCTCCTCAGGCTGC
CGATACGGTAAGTCTATCA->GATACGGTAAGTCTATCAA
GAGACTATAGACTTCGTGT->AGACTATAGACTTCGTGTC
TGCCGTCCCGACCGCATTT->GCCGTCCCGACCGCATTTG
GCCGTCCCGACCGCATTTG->CCGTCCCGACCGCATTTGA
TGCTGCAAACGGGTACAAA->GCTGCAAACGGGTACAAAC
AAGGAGCAAGTCAATTACC->AGGAGCAAGTCAATTACCG
AGGAGCAAGTCAATTACCG->GGAGCAAGTCAATTACCGT
CGTTTGTACCTCGCTTTAT->GTTTGTACCTCGCTTTATA
TATTTCTGAATTGTCTGCC->ATTTCTGAATTGTCTGCCG
TGGTAACCTTCGATGCTGT->GGTAACCTTCGATGCTGTA
CTTGTTAACTAACGATGCA->TTGTTAACTAACGATGCAG
AGCAGGATTCGGCTTGACA->GCAGGATTCGGCTTGACAG
ATTGATCGTGCAAGGTCAC->TTGATCGTGCAAGGTCACA
AGAACTGAGTAAACAGGAT->GAACTGAGTAAACAGGATG
TTCGTTGTGGGCTTTTATT->TCGTTGTGGGCTTTTATTT
GAAACCACTCGAAGGCGAG->AAACCACTCGAAGGCGAGT
ATTGTACCTTGTAGTGTCT->TTGTACCTTGTAGTGTCTT
GAATCCTGCATATGGAGGG->AATCCTGCATATGGAGGGG
GATTGAGGCAGCTGTGGCA->ATTGAGGCAGCTGTGGCAT
GCCGTAGTAGTGGAGCTCA->CCGTAGTAGTGGAGCTCAG
CTTTGCTCCCCTCGGGCAT->TTTGCTCCCCTCGGGCATA
GTGCCGTAGTAGTGGAGCT->TGCCGTAGTAGTGGAGCTC
AGAAACACCCCGTCCGCAG->GAAACACCCCGTCCGCAGA
ATAGCAGGATTCGGCTTGA->TAGCAGGATTCGGCTTGAC
GCAGGTCGGAATACCGCCA->CAGGTCGGAATACCGCCAG
GGCGAATGGACATTGTAGG->GCGAATGGACATTGTAGGG
CGCAAGCCAGAACAAAGCC->GCAAGCCAGAACAAAGCCC
GTGTTGCACCCTAACCTGT->TGTTGCACCCTAACCTGTT
TATATATGCCTACTCCTTT->ATATATGCCTACTCCTTTT
TCAACCGTCTAGTCTTGGA->CAACCGTCTAGTCTTGGAC
GCCCCCGTATCGGCATCAT->CCCCCGTATCGGCATCATC
GGCCTTGCCCTCACAGTGC->GCCTTGCCCTCACAGTGCG
CCCCGTATCGGCATCATCA->CCCGTATCGGCATCATCAT
GCATGTCCATCCTACGCCC->CATGTCCATCCTACGCCCT
GCCGTCTCCGAGTCAGCTA->CCGTCTCCGAGTCAGCTAT
GGAGACGGTCCTGATCTAT->GAGACGGTCCTGATCTATT
GCAAGTCAATTACCGTCAG->CAAGTCAATTACCGTCAGA
CCCGACCATCCCTCTCGGC->CCGACCATCCCTCTCGGCA
CCAGAAGAACAACGTTCGA->CAGAAGAACAACGTTCGAT
AGATATGCCCGACCATCCC->GATATGCCCGACCATCCCT
CCTCCTACCGAGCTAAGTC->CTCCTACCGAGCTAAGTCT
ACGAACGCCGTCTCCGAGT->CGAACGCCGTCTCCGAGTC
TCATGGCCTTGACGGCAAG->CATGGCCTTGACGGCAAGC
GCGCGTTCGTTCTCTTAGG->CGCGTTCGTTCTCTTAGGC
AAACCCGTCTGGCCTTGCC->AACCCGTCTGGCCTTGCCC
AATACCGCCAGCATCGGGC->ATACCGCCAGCATCGGGCG
CGTCTGGCCTTGCCCTCAC->GTCTGGCCTTGCCCTCACA
TTGAGACTATAGACTTCGT->TGAGACTATAGACTTCGTG
GTTCTCTTAGGCAGGTCGG->TTCTCTTAGGCAGGTCGGA
CCATCGCTGAGGAATACTT->CATCGCTGAGGAATACTTG
GGCATTGAGACTATAGACT->GCATTGAGACTATAGACTT
AGGATGGCATGGGCTATAT->GGATGGCATGGGCTATATA
TGTACCTTGTAGTGTCTTA->GTACCTTGTAGTGTCTTAG
ACGATGCGTGGTCTTGCGC->CGATGCGTGGTCTTGCGCT
TTAATCCAAAACCCTGTAG->TAATCCAAAACCCTGTAGC
TGCAAACGGGTACAAACCG->GCAAACGGGTACAAACCGA
AAACGATGCGTGGTCTTGC->AACGATGCGTGGTCTTGCG
AGTAAGATTATTACCGACC->GTAAGATTATTACCGACCG
ATGGGAATATATATGCCTA->TGGGAATATATATGCCTAC
AGAACCCCCCGTGGTCTTT->GAACCCCCCGTGGTCTTTA
GTGTTAGCATAGCCGGGGG->TGTTAGCATAGCCGGGGGA
AACTAACTCGTCGCCGTAG->ACTAACTCGTCGCCGTAGG
GACCATCCCTCTCGGCATT->ACCATCCCTCTCGGCATTG
GCAGCAGCGGCAGCTGTGG->CAGCAGCGGCAGCTGTGGC
TTCGTGTGCCGTAGTAGTG->TCGTGTGCCGTAGTAGTGG
GGAGAAACACCCCGTCCGC->GAGAAACACCCCGTCCGCA
ACTAACACACGGATTGAGG->CTAACACACGGATTGAGGC
CCGTCTGGCCTTGCCCTCA->CGTCTGGCCTTGCCCTCAC
AATGGGAATATATATGCCT->ATGGGAATATATATGCCTA
TCTGAATTGTCTGCCGCAT->CTGAATTGTCTGCCGCATT
GGGAGTGTTAGCATAGCCG->GGAGTGTTAGCATAGCCGG
CGCATTCTGCTCGTATATA->GCATTCTGCTCGTATATAC
CCGTTATGGAATGTAGGGT->CGTTATGGAATGTAGGGTC
AGCTAAGTCTCCTTTATCA->GCTAAGTCTCCTTTATCAG
CAGATATGCCCGACCATCC->AGATATGCCCGACCATCCC
GTAAACAGGATGGCATGGG->TAAACAGGATGGCATGGGC
CGTATCGGCATCATCATTT->GTATCGGCATCATCATTTC
CTGGTAATTATTGTCCCTT->TGGTAATTATTGTCCCTTT
TAATGGGTCAGATTGCTTA->AATGGGTCAGATTGCTTAT
GCAGAACTGAGTAAACAGG->CAGAACTGAGTAAACAGGA
CTCCCGTTATGGAATGTAG->TCCCGTTATGGAATGTAGG
GGCGTACATGCCCATCGCT->GCGTACATGCCCATCGCTG
ATACGGTAAGTCTATCAAA->TACGGTAAGTCTATCAAAC
ATACTTGTTAACTAACCTC->TACTTGTTAACTAACCTCG
GTGATCAATAATGAAAAAT->TGATCAATAATGAAAAATG
TCGACGCTAAGGCAGCTGT->CGACGCTAAGGCAGCTGTG
ATTGAGGCAGCTGTGGCAT->TTGAGGCAGCTGTGGCATT
GATCTATTGTAATGGGTCA->ATCTATTGTAATGGGTCAG
AGTACGTTCCAAGCCCCCG->GTACGTTCCAAGCCCCCGT
CAAATGTATTGATCTCCTG->AAATGTATTGATCTCCTGG
TTGAAGGGTCGCTGGAAGG->TGAAGGGTCGCTGGAAGGA
GATTGCTTATTATACAGCC->ATTGCTTATTATACAGCCA
GGGAATATATATGCCTACT->GGAATATATATGCCTACTC
TGAGTCGTCGACTCGCATT->GAGTCGTCGACTCGCATTC
CCGGGGGATTTGAAGGGTC->CGGGGGATTTGAAGGGTCG
TACAGCATTAGCACTCGCG->ACAGCATTAGCACTCGCGG
CTTGTTAACTAACTCGTCG->TTGTTAACTAACTCGTCGC
GACAGATTTCATTCATCTG->ACAGATTTCATTCATCTGC
CTTAGATCTTTATGTTCGT->TTAGATCTTTATGTTCGTG
TATTATACAGCCAGAAGAA->ATTATACAGCCAGAAGAAC
TGGCCTGAACACGAAGACC->GGCCTGAACACGAAGACCT
TTTGTACGCTACAGGGCGC->TTGTACGCTACAGGGCGCG
TAGTAGTGGAGCTCAGAAC->AGTAGTGGAGCTCAGAACC
ATAGCCGGGGGATTTGAAG->TAGCCGGGGGATTTGAAGG
CGCTAAGGCAGCTGTGGCA->GCTAAGGCAGCTGTGGCAT
AATACTTGTTAACTAACTC->ATACTTGTTAACTAACTCG
GTACCTGTGGTTTGAGTCG->TACCTGTGGTTTGAGTCGT
TTGAGTTGTGCTGCAAACG->TGAGTTGTGCTGCAAACGG
TAGGAGACGGTCCTGATCT->AGGAGACGGTCCTGATCTA
GTATTGATCTCCTGGGTGC->TATTGATCTCCTGGGTGCG
GCGTCGATGGACATTGCAT->CGTCGATGGACATTGCATC
TCGGCCACAAATACGGAGA->CGGCCACAAATACGGAGAA
AAGAGTGGAAAAGAGGGAG->AGAGTGGAAAAGAGGGAGA
CCATGGAAGTCCTTAATCC->CATGGAAGTCCTTAATCCA
GAGTCGTCCATGGCCTGAA->AGTCGTCCATGGCCTGAAC
CACCCTAACCTGTTAGTTG->ACCCTAACCTGTTAGTTGC
GGCAGCTGTGGCATTTTAA->GCAGCTGTGGCATTTTAAT,GCAGCTGTGGCATTTTAAA,GCAGCTGTGGCATTTTAAA,GCAGCTGTGGCATTTTAAG
GCAGAGCGTATTTGCAGTA->CAGAGCGTATTTGCAGTAA
TAGGCAGGTCGGAATACCG->AGGCAGGTCGGAATACCGC
GCGTTGCCTGAATCTTTGC->CGTTGCCTGAATCTTTGCT
CCCCGTGGTCTTTACTTCG->CCCGTGGTCTTTACTTCGG
CAAAGTATCTTCGGCCACA->AAAGTATCTTCGGCCACAA
TCCGCAGACACGTCGCCCT->CCGCAGACACGTCGCCCTC
GCGTTGCGCGTCTGTCTCA->CGTTGCGCGTCTGTCTCAC
GTACAAACCGAGACCACTC->TACAAACCGAGACCACTCT
CCATTAAACCCGTCTGGCC->CATTAAACCCGTCTGGCCT
GAAACGATGCGTGGTCTTG->AAACGATGCGTGGTCTTGC
CTCGAAGGCGAGTCGTCCA->TCGAAGGCGAGTCGTCCAT
TACAAACCGAGACCACTCT->ACAAACCGAGACCACTCTG
CTACCGAGCTAAGTCTCCT->TACCGAGCTAAGTCTCCTT
GCGAATGGACATTGTAGGG->CGAATGGACATTGTAGGGA
GTGGCATTTTAAAGCGACT->TGGCATTTTAAAGCGACTC
ATTACCGACCGTGCTACCC->TTACCGACCGTGCTACCCC
ACATTGCATCATCACTCAT->CATTGCATCATCACTCATG
CAAACGGGTACAAACCGAG->AAACGGGTACAAACCGAGA
TCTCTTAGGCAGGTCGGAA->CTCTTAGGCAGGTCGGAAT
ACGCCCTCTCCACCGAGCC->CGCCCTCTCCACCGAGCCG
AAGTGGGAGCACTACAGCA->AGTGGGAGCACTACAGCAT
TGTAGGGAGTCAACGAGTG->GTAGGGAGTCAACGAGTGG
CAACCGTCTAGTCTTGGAC->AACCGTCTAGTCTTGGACG
TCGCCTCTCAAATGTATTG->CGCCTCTCAAATGTATTGA
ATTGCATCATCACTCATGG->TTGCATCATCACTCATGGC
CTCAAGAACCCCCCGTGGT->TCAAGAACCCCCCGTGGTC
AAAGCGACTCGTCAGTTCC->AAGCGACTCGTCAGTTCCA
CTTATTATACAGCCAGAAG->TTATTATACAGCCAGAAGA
ATTCCTCGTTCAACTATAC->TTCCTCGTTCAACTATACG
TTGTGGGCTTTTATTTCTG->TGTGGGCTTTTATTTCTGA
GCTTTCTACTACCATTTCG->CTTTCTACTACCATTTCGC
TCGCTGGAAGGAGCTAGCA->CGCTGGAAGGAGCTAGCAC
TTGCCGAGTGTGAGTAAGA->TGCCGAGTGTGAGTAAGAA
CGTCTCCGAGTCAGCTATT->GTCTCCGAGTCAGCTATTC
TCCCTTTGGTAACCTTCGA->CCCTTTGGTAACCTTCGAT
GTCCTGATCTATTGTAATG->TCCTGATCTATTGTAATGG
CGAAGGCGAGTCGTCCATG->GAAGGCGAGTCGTCCATGG
CAGTAAGATTATTACCGAC->AGTAAGATTATTACCGACC
ATGCCCATCGCTGAGGAAT->TGCCCATCGCTGAGGAATA
TAGCACAAACGATAACGGC->AGCACAAACGATAACGGCA
ATCCTGCATATGGAGGGGC->TCCTGCATATGGAGGGGCG
TGGTCTTGCGCTCTTGTAT->GGTCTTGCGCTCTTGTATA
CACAGTGCGCCGTCTCGAT->ACAGTGCGCCGTCTCGATG
TTTTAATTTAGCCATAACG->TTTAATTTAGCCATAACGC
TCCGGTCTCCCGTTATGGA->CCGGTCTCCCGTTATGGAA
CGGCAGCTGTGGCATTTTA->GGCAGCTGTGGCATTTTAA
CATAACGCACGCTCTTGTG->ATAACGCACGCTCTTGTGT
ACTGCTGGAATCCTGCATA->CTGCTGGAATCCTGCATAT
CACTCATGGCCTTGACGGC->ACTCATGGCCTTGACGGCA
CGTACCTGTGGTTTGAGTC->GTACCTGTGGTTTGAGTCG
CCCCGGCGTTGGGTATGCG->CCCGGCGTTGGGTATGCGT
TATATACAAAGTATCTTCG->ATATACAAAGTATCTTCGG
CGGCGTCCGCGAGTTAGCC->GGCGTCCGCGAGTTAGCCG
TAACCTCGACGCTAAGGCA->AACCTCGACGCTAAGGCAG
CTTGCAACACAAGTGTTGC->TTGCAACACAAGTGTTGCA
CGTTGTGGGCTTTTATTTC->GTTGTGGGCTTTTATTTCT
GGCTTGACAGATTTCATTC->GCTTGACAGATTTCATTCA
GTTCCATGGAAGTCCTTAA->TTCCATGGAAGTCCTTAAT
CATCATCATTTCTTAGATC->ATCATCATTTCTTAGATCT
CACGAAGACCTACACGAGG->ACGAAGACCTACACGAGGA
CTCGAGAACTCACGAGTCT->TCGAGAACTCACGAGTCTA
GCCTGAACACGAAGACCTA->CCTGAACACGAAGACCTAC
CCGCCTGAATGCCGTTTGT->CGCCTGAATGCCGTTTGTA
CGGTTGCTGGAGGACATTT->GGTTGCTGGAGGACATTTA
CATGGGCTATATACAAAGT->ATGGGCTATATACAAAGTA
ACGGAGAAACACCCCGTCC->CGGAGAAACACCCCGTCCG
GCGCTCTTGTATACTGTGT->CGCTCTTGTATACTGTGTC
AACCCCCCGTGGTCTTTAC->ACCCCCCGTGGTCTTTACT
GTAGGGTCCGCCATGAGCT->TAGGGTCCGCCATGAGCTT
CCGTCCGCAGACACGTCGC->CGTCCGCAGACACGTCGCC
AAATACGGAGAAACACCCC->AATACGGAGAAACACCCCG
TGCATATGGAGGGGCGCAG->GCATATGGAGGGGCGCAGT
AACGATGCGTGGTCTTGCG->ACGATGCGTGGTCTTGCGC
CGTTCGATCAGAAAGAGGC->GTTCGATCAGAAAGAGGCA
CGGAGAAACACCCCGTCCG->GGAGAAACACCCCGTCCGC
ATTCGGCTTGACAGATTTC->TTCGGCTTGACAGATTTCA
CCAGCGCGTCGATGGACAT->CAGCGCGTCGATGGACATT
TCGATGCTGTATAAAGAGT->CGATGCTGTATAAAGAGTG
CGGTCTCCCGTTATGGAAT->GGTCTCCCGTTATGGAATG
TTGTCGGGTCTATAAGTAC->TGTCGGGTCTATAAGTACG
AACGCACGCTCTTGTGTAA->ACGCACGCTCTTGTGTAAA
GCTCTTGTGTAAACGAATA->CTCTTGTGTAAACGAATAC
AGTCGTCGACTCGCATTCT->GTCGTCGACTCGCATTCTG
TGAATCTTTGCTCCCCTCG->GAATCTTTGCTCCCCTCGG
AAAGAGGGAGATCTAGCAT->AAGAGGGAGATCTAGCATG
CGAGTCAGCTATTCATGAA->GAGTCAGCTATTCATGAAT
TGGCATTTTAATTTAGCCA->GGCATTTTAATTTAGCCAT
CAGCGCGTCGATGGACATT->AGCGCGTCGATGGACATTG
AACACAAGTGTTGCACCCT->ACACAAGTGTTGCACCCTA
GAAGACCTACACGAGGACA->AAGACCTACACGAGGACAT
TCAGATTGCTTATTATACA->CAGATTGCTTATTATACAG
TTGCTGGAGGACATTTAGT->TGCTGGAGGACATTTAGTC
ATCAATAATGAAAAATGAC->TCAATAATGAAAAATGACG
ACTAACCTCGACGCTAAGG->CTAACCTCGACGCTAAGGC
AGAAGGCTCCTCAGGCTGC->GAAGGCTCCTCAGGCTGCG
TCCATGGAAGTCCTTAATC->CCATGGAAGTCCTTAATCC
CTGTAGCACAAACGATAAC->TGTAGCACAAACGATAACG
ACGTTCGATCAGAAAGAGG->CGTTCGATCAGAAAGAGGC
GGAGCACTACAGCATTAGC->GAGCACTACAGCATTAGCA
TACCTCGCTTTATAAAGGG->ACCTCGCTTTATAAAGGGA
GGCGTCCGCGAGTTAGCCG->GCGTCCGCGAGTTAGCCGA
ATTTGAATTCCTCGTTCAA->TTTGAATTCCTCGTTCAAC
CTCAAATGTATTGATCTCC->TCAAATGTATTGATCTCCT
ACTATACGATGACTGCTGG->CTATACGATGACTGCTGGA
CGAATTGTACCTTGTAGTG->GAATTGTACCTTGTAGTGT
TTCTGCTCGTATATACTCA->TCTGCTCGTATATACTCAA
GACTAACATACTAAAGTGG->ACTAACATACTAAAGTGGC
AGGCTCCTCAGGCTGCGCC->GGCTCCTCAGGCTGCGCCT
CTCGACGCTAAGGCAGCTG->TCGACGCTAAGGCAGCTGT
ATGCTGTATAAAGAGTGGA->TGCTGTATAAAGAGTGGAA
AAGGTCACAGCCAGGGGTG->AGGTCACAGCCAGGGGTGC
AAAGTGGCCGCCTGAATGC->AAGTGGCCGCCTGAATGCC
TTTAAAGGAGCAAGTCAAT->TTAAAGGAGCAAGTCAATT
CTGAGTAAACAGGATGGCA->TGAGTAAACAGGATGGCAT
TGGACATTGTAGGGAGTCA->GGACATTGTAGGGAGTCAA
AGCAGCGGCAGCTGTGGCA->GCAGCGGCAGCTGTGGCAT
TACCGAGCTAAGTCTCCTT->ACCGAGCTAAGTCTCCTTT
GAATACTTGTTAACTAACC->AATACTTGTTAACTAACCT
GCAAGCCAGAACAAAGCCC->CAAGCCAGAACAAAGCCCG
GGTGCATCAACAGTCTTGT->GTGCATCAACAGTCTTGTC
TCCATGGCCTGAACACGAA->CCATGGCCTGAACACGAAG
TGGCCTTGACGGCAAGCGA->GGCCTTGACGGCAAGCGAA
CGGTCCTGATCTATTGTAA->GGTCCTGATCTATTGTAAT
AGGGGCGCAGTGTGCTTTC->GGGGCGCAGTGTGCTTTCT
CATTTCTTAGATCTTTATG->ATTTCTTAGATCTTTATGT
CATTGCCGTCCCGACCGCA->ATTGCCGTCCCGACCGCAT
AGTGTAGGCATACGCCCCA->GTGTAGGCATACGCCCCAG
TACACGAGGACATAGTGTG->ACACGAGGACATAGTGTGG
TGGGCGAATGGACATTGTA->GGGCGAATGGACATTGTAG
CCGGCGTTGGGTATGCGTT->CGGCGTTGGGTATGCGTTG
ATATACTCAACCGTCTAGT->TATACTCAACCGTCTAGTC
TGTGTCGCGCAAGCCAGAA->GTGTCGCGCAAGCCAGAAC
AGTAAGAATACTTGTTAAC->GTAAGAATACTTGTTAACT
CCTGCTGCTTCGTTGTGGG->CTGCTGCTTCGTTGTGGGC
TCTCGGCATTGAGACTATA->CTCGGCATTGAGACTATAG
GCCTGGTAATTATTGTCCC->CCTGGTAATTATTGTCCCT
CGTCGCCGTAGGCAGCTGT->GTCGCCGTAGGCAGCTGTG
TCTTTATGTTCGTGTGCCG->CTTTATGTTCGTGTGCCGT
TACGCTACAGGGCGCGTTC->ACGCTACAGGGCGCGTTCG
TGATCTATTGTAATGGGTC->GATCTATTGTAATGGGTCA
CGGCTCGAGAACTCACGAG->GGCTCGAGAACTCACGAGT
AAACGATAACGGCAGACTA->AACGATAACGGCAGACTAA
GGAGGGGCGCAGTGTGCTT->GAGGGGCGCAGTGTGCTTT
ATGAGCTTGATTCCAATCT->TGAGCTTGATTCCAATCTG
GGTCTTGCGCTCTTGTATA->GTCTTGCGCTCTTGTATAC
TCTGCCGCATTCAGCGGCG->CTGCCGCATTCAGCGGCGT
GCATTTTAATTTAGCCATA->CATTTTAATTTAGCCATAA
GCTGCTTCGTTGTGGGCTT->CTGCTTCGTTGTGGGCTTT
TAATTTAGCCATAACGCAC->AATTTAGCCATAACGCACG
CAATTAGGAGACGGTCCTG->AATTAGGAGACGGTCCTGA
CGGCCACAAATACGGAGAA->GGCCACAAATACGGAGAAA
TAAGTCTATCAAACAATTA->AAGTCTATCAAACAATTAG
ATCAAACAATTAGGAGACG->TCAAACAATTAGGAGACGG
CATAGCCGGGGGATTTGAA->ATAGCCGGGGGATTTGAAG
CTTGGACGACGGATCGCCG->TTGGACGACGGATCGCCGG
GGGAACCTAATGGGAATAT->GGAACCTAATGGGAATATA
CATTTCGCAAAGGGTGATC->ATTTCGCAAAGGGTGATCA
GGCGTTGGGTATGCGTTGC->GCGTTGGGTATGCGTTGCG
TAGACTTCGTGTCCTTGCA->AGACTTCGTGTCCTTGCAA
TTGGACGACGGATCGCCGG->TGGACGACGGATCGCCGGC
TACCGTCAGAAGGCTCCTC->ACCGTCAGAAGGCTCCTCA
AATCTGTCGAAGTCGGCAG->ATCTGTCGAAGTCGGCAGA
CCTGAATGCCGTTTGTACC->CTGAATGCCGTTTGTACCT
TATTGTAATGGGTCAGATT->ATTGTAATGGGTCAGATTG
TCTTAGCATTGCCGTCCCG->CTTAGCATTGCCGTCCCGA
TTGCCTGAATCTTTGCTCC->TGCCTGAATCTTTGCTCCC
TTTTATTTCTGAATTGTCT->TTTATTTCTGAATTGTCTG
ACTGTGTCGCGCAAGCCAG->CTGTGTCGCGCAAGCCAGA
GCAGAGTTCGAACCGGTAC->CAGAGTTCGAACCGGTACA
GTCAGCTATTCATGAATAC->TCAGCTATTCATGAATACT
GATCGCCGGCTCGAGAACT->ATCGCCGGCTCGAGAACTC
TGCCTGAATCTTTGCTCCC->GCCTGAATCTTTGCTCCCC
AACGATAACGGCAGACTAA->ACGATAACGGCAGACTAAC
AAGTATCTTCGGCCACAAA->AGTATCTTCGGCCACAAAT
CATTTTAAAGCGACTCGTC->ATTTTAAAGCGACTCGTCA
TCTAGTCTTGGACGACGGA->CTAGTCTTGGACGACGGAT
AATGGGTCAGATTGCTTAT->ATGGGTCAGATTGCTTATT
AGGGAACCTAATGGGAATA->GGGAACCTAATGGGAATAT
AGCCAGAACAAAGCCCGCC->GCCAGAACAAAGCCCGCCC
CTTTATAAAGGGAAACGAT->TTTATAAAGGGAAACGATG
AGCGAAACCACTCGAAGGC->GCGAAACCACTCGAAGGCG
GTGTAAACGAATACTTGTT->TGTAAACGAATACTTGTTA
TTTGCAGTAAGATTATTAC->TTGCAGTAAGATTATTACC
CTAACATACTAAAGTGGCC->TAACATACTAAAGTGGCCG
AACCGGTACATTTGCCGAG->ACCGGTACATTTGCCGAGT
TAACTCGTCGCCGTAGGCA->AACTCGTCGCCGTAGGCAG
AGCATAACCCTGCTGCTTC->GCATAACCCTGCTGCTTCG
CACGGATTGAGGCAGCTGT->ACGGATTGAGGCAGCTGTG
CGTTCCGGTCTCCCGTTAT->GTTCCGGTCTCCCGTTATG
TGGACGACGGATCGCCGGC->GGACGACGGATCGCCGGCT
CTCTTGTATACTGTGTCGC->TCTTGTATACTGTGTCGCG
GCTGCAAACGGGTACAAAC->CTGCAAACGGGTACAAACC
AGTTGTGCTGCAAACGGGT->GTTGTGCTGCAAACGGGTA
GTCTACATTGGGCGAATGG->TCTACATTGGGCGAATGGA
GTCTGTCTCACGAACGCCG->TCTGTCTCACGAACGCCGT
AGCTGTGGCATTTTAAGTG->GCTGTGGCATTTTAAGTGG
GCTAAGTCTCCTTTATCAG->CTAAGTCTCCTTTATCAGA
CAGCAGCGGCAGCTGTGGC->AGCAGCGGCAGCTGTGGCA
GAGCGTATTTGCAGTAAGA->AGCGTATTTGCAGTAAGAT
ACAAACGATAACGGCAGAC->CAAACGATAACGGCAGACT
ATCATTTCTTAGATCTTTA->TCATTTCTTAGATCTTTAT
TATATACTCAACCGTCTAG->ATATACTCAACCGTCTAGT
TGAAAAATGACGAGGCGTG->GAAAAATGACGAGGCGTGT
CTTGTGTAAACGAATACTT->TTGTGTAAACGAATACTTG
TGGTAATTATTGTCCCTTT->GGTAATTATTGTCCCTTTG
CTAGCACGATACGGTAAGT->TAGCACGATACGGTAAGTC
CTCTGCAGCATAACCCTGC->TCTGCAGCATAACCCTGCT
TATCGGCATCATCATTTCT->ATCGGCATCATCATTTCTT
CTTTATGTTCGTGTGCCGT->TTTATGTTCGTGTGCCGTA
CATTGTAGGGAGTCAACGA->ATTGTAGGGAGTCAACGAG
GTCGCTGGAAGGAGCTAGC->TCGCTGGAAGGAGCTAGCA
CCTAACCTGTTAGTTGCTG->CTAACCTGTTAGTTGCTGC
TGGTCTTTACTTCGGTTGC->GGTCTTTACTTCGGTTGCT
ACGATGCAGCAGCGGCAGC->CGATGCAGCAGCGGCAGCT
ATGGGCTATATACAAAGTA->TGGGCTATATACAAAGTAT
CCGTGGTCTTTACTTCGGT->CGTGGTCTTTACTTCGGTT
CGTCCGCAGACACGTCGCC->GTCCGCAGACACGTCGCCC
AATTGTCTGCCGCATTCAG->ATTGTCTGCCGCATTCAGC
GAGGCGTGTATCAAGGGAA->AGGCGTGTATCAAGGGAAC
TGATCGTGCAAGGTCACAG->GATCGTGCAAGGTCACAGC
GCACGCTCTTGTGTAAACG->CACGCTCTTGTGTAAACGA
GTCAATTACCGTCAGAAGG->TCAATTACCGTCAGAAGGC
TACCGACCGTGCTACCCCA->ACCGACCGTGCTACCCCAT
GCAAGGTCACAGCCAGGGG->CAAGGTCACAGCCAGGGGT
TCACGAGTCTACATTGGGC->CACGAGTCTACATTGGGCG
GTCCATGGCCTGAACACGA->TCCATGGCCTGAACACGAA
GGCATTTTAAAGCGACTCG->GCATTTTAAAGCGACTCGT
ATTTTAAGTGGGAGCACTA->TTTTAAGTGGGAGCACTAC
GAATACTTGTTAACTAACA->AATACTTGTTAACTAACAC
ACGTTCCAAGCCCCCGTAT->CGTTCCAAGCCCCCGTATC
ATGGACATTGCATCATCAC->TGGACATTGCATCATCACT
TAGCACTCGCGGGAGTGTT->AGCACTCGCGGGAGTGTTA
ATCAGAAAGAGGCAGTGTA->TCAGAAAGAGGCAGTGTAG
CTGGCCTTGCCCTCACAGT->TGGCCTTGCCCTCACAGTG
CTACTACCATTTCGCAAAG->TACTACCATTTCGCAAAGG
CTCTCGGCATTGAGACTAT->TCTCGGCATTGAGACTATA
TATACAAAGTATCTTCGGC->ATACAAAGTATCTTCGGCC
TGGTTTGAGTCGTCGACTC->GGTTTGAGTCGTCGACTCG
CAGCATAACCCTGCTGCTT->AGCATAACCCTGCTGCTTC
TGAGTTGTGCTGCAAACGG->GAGTTGTGCTGCAAACGGG
TGCCCGACCATCCCTCTCG->GCCCGACCATCCCTCTCGG
CGAGTGGCGTACATGCCCA->GAGTGGCGTACATGCCCAT
GTGGGAGCACTACAGCATT->TGGGAGCACTACAGCATTA
CGGCATTGAGACTATAGAC->GGCATTGAGACTATAGACT
GGCATTTTAAGTGGGAGCA->GCATTTTAAGTGGGAGCAC
TGGCGTACATGCCCATCGC->GGCGTACATGCCCATCGCT
GCGGCGTCCGCGAGTTAGC->CGGCGTCCGCGAGTTAGCC
AGGACATTTAGTCTCGACC->GGACATTTAGTCTCGACCG
GTGTAGGCATACGCCCCAG->TGTAGGCATACGCCCCAGC
TTCCATGGAAGTCCTTAAT->TCCATGGAAGTCCTTAATC
GTGTGCCGTAGTAGTGGAG->TGTGCCGTAGTAGTGGAGC
CGCCTGAATGCCGTTTGTA->GCCTGAATGCCGTTTGTAC
CCCTTTGGTAACCTTCGAT->CCTTTGGTAACCTTCGATG
GGCGCGTTCGTTCTCTTAG->GCGCGTTCGTTCTCTTAGG
CGCCGTCTCGATGCATCTG->GCCGTCTCGATGCATCTGT
CGCGTCTGTCTCACGAACG->GCGTCTGTCTCACGAACGC
GTCAGAAGGCTCCTCAGGC->TCAGAAGGCTCCTCAGGCT
TACAGCCAGAAGAACAACG->ACAGCCAGAAGAACAACGT
GCTACAGGGCGCGTTCGTT->CTACAGGGCGCGTTCGTTC
TAAACGAATACTTGTTAAC->AAACGAATACTTGTTAACT
CGCGTTCGTTCTCTTAGGC->GCGTTCGTTCTCTTAGGCA
GATCTAGCATGTCCATCCT->ATCTAGCATGTCCATCCTA
AATTAGGAGACGGTCCTGA->ATTAGGAGACGGTCCTGAT
TTTCATTCATCTGCTCGAT->TTCATTCATCTGCTCGATC
CTCGATCGTTTCGCCTCTC->TCGATCGTTTCGCCTCTCA
GAGCTAGCACGATACGGTA->AGCTAGCACGATACGGTAA
TGCTGGAGGACATTTAGTC->GCTGGAGGACATTTAGTCT
TGCCCTCACAGTGCGCCGT->GCCCTCACAGTGCGCCGTC
CCGAGCCGTATTGAGTTGT->CGAGCCGTATTGAGTTGTG
CTGTGTCGCGCAAGCCAGA->TGTGTCGCGCAAGCCAGAA
CTTCGGCCACAAATACGGA->TTCGGCCACAAATACGGAG
GCCATGAGCTTGATTCCAA->CCATGAGCTTGATTCCAAT
AGTGTTGCACCCTAACCTG->GTGTTGCACCCTAACCTGT
GCAGTAAGATTATTACCGA->CAGTAAGATTATTACCGAC
CCCATTAAACCCGTCTGGC->CCATTAAACCCGTCTGGCC
GCCTGAATCTTTGCTCCCC->CCTGAATCTTTGCTCCCCT
GGTCAGATTGCTTATTATA->GTCAGATTGCTTATTATAC
TCAACTATACGATGACTGC->CAACTATACGATGACTGCT
CAGTCTTGTCGGGTCTATA->AGTCTTGTCGGGTCTATAA
GGGAGATCTAGCATGTCCA->GGAGATCTAGCATGTCCAT
CGCCCTCTCCACCGAGCCG->GCCCTCTCCACCGAGCCGT
GATCGTTTCGCCTCTCAAA->ATCGTTTCGCCTCTCAAAT
CGGGTCTATAAGTACGTTC->GGGTCTATAAGTACGTTCC
CCACTCTGCAGCATAACCC->CACTCTGCAGCATAACCCT
ATACGGAGAAACACCCCGT->TACGGAGAAACACCCCGTC
CATTTGAATTCCTCGTTCA->ATTTGAATTCCTCGTTCAA
ATACAAAGTATCTTCGGCC->TACAAAGTATCTTCGGCCA
GAAGGCTCCTCAGGCTGCG->AAGGCTCCTCAGGCTGCGC
TGCCAAAGCGTACCTGTGG->GCCAAAGCGTACCTGTGGT
AGTGTTAGCATAGCCGGGG->GTGTTAGCATAGCCGGGGG
GTGTCCTTGCAACACAAGT->TGTCCTTGCAACACAAGTG
TACTAAAGTGGCCGCCTGA->ACTAAAGTGGCCGCCTGAA
TCCTCAGGCTGCGCCTGGT->CCTCAGGCTGCGCCTGGTA
CATTGAGACTATAGACTTC->ATTGAGACTATAGACTTCG
CCGTGCTACCCCATTAAAC->CGTGCTACCCCATTAAACC
TCCTTTTGTACGCTACAGG->CCTTTTGTACGCTACAGGG
AGACACGTCGCCCTCCTAC->GACACGTCGCCCTCCTACC
CCTCGCTTTATAAAGGGAA->CTCGCTTTATAAAGGGAAA
CATTCTGCTCGTATATACT->ATTCTGCTCGTATATACTC
TTGACAGATTTCATTCATC->TGACAGATTTCATTCATCT
GTAGGCAGCTGTGGCATTT->TAGGCAGCTGTGGCATTTT
CAGCTATTCATGAATACTT->AGCTATTCATGAATACTTG
GTACCTTGTAGTGTCTTAG->TACCTTGTAGTGTCTTAGC
AACGGCAGACTAACATACT->ACGGCAGACTAACATACTA
CTATTCATGAATACTTGTT->TATTCATGAATACTTGTTA
TGGAGGACATTTAGTCTCG->GGAGGACATTTAGTCTCGA
TAAGAATACTTGTTAACTA->AAGAATACTTGTTAACTAA
TTTGGTAACCTTCGATGCT->TTGGTAACCTTCGATGCTG
AACGTTCGATCAGAAAGAG->ACGTTCGATCAGAAAGAGG
GAGTTAGCCGAATTGTACC->AGTTAGCCGAATTGTACCT
TGGCATTTTAAAGGAGCAA->GGCATTTTAAAGGAGCAAG
CACCGAGCCGTATTGAGTT->ACCGAGCCGTATTGAGTTG
TACGGAGAAACACCCCGTC->ACGGAGAAACACCCCGTCC
GAAGAACAACGTTCGATCA->AAGAACAACGTTCGATCAG
GCGCGTCGATGGACATTGC->CGCGTCGATGGACATTGCA
TTACCGACCGTGCTACCCC->TACCGACCGTGCTACCCCA
TAAAGTGGCCGCCTGAATG->AAAGTGGCCGCCTGAATGC
TCGCTGAGGAATACTTGTT->CGCTGAGGAATACTTGTTA
TACTTCGGTTGCTGGAGGA->ACTTCGGTTGCTGGAGGAC
TAACGGCAGACTAACATAC->AACGGCAGACTAACATACT
AATTTAGCCATAACGCACG->ATTTAGCCATAACGCACGC
ATAACGCACGCTCTTGTGT->TAACGCACGCTCTTGTGTA
CCGTATCGGCATCATCATT->CGTATCGGCATCATCATTT
TCGTGTCCTTGCAACACAA->CGTGTCCTTGCAACACAAG
TACGGTAAGTCTATCAAAC->ACGGTAAGTCTATCAAACA
TCAAACAATTAGGAGACGG->CAAACAATTAGGAGACGGT
CGTCTGTCTCACGAACGCC->GTCTGTCTCACGAACGCCG
GCACTACAGCATTAGCACT->CACTACAGCATTAGCACTC
GAATATATATGCCTACTCC->AATATATATGCCTACTCCT
TGTAAACGAATACTTGTTA->GTAAACGAATACTTGTTAA
ATCTGCTCGATCGTTTCGC->TCTGCTCGATCGTTTCGCC
ACCTCGACGCTAAGGCAGC->CCTCGACGCTAAGGCAGCT
ATTGAGACTATAGACTTCG->TTGAGACTATAGACTTCGT
CGATGCGTGGTCTTGCGCT->GATGCGTGGTCTTGCGCTC
AGCTATTCATGAATACTTG->GCTATTCATGAATACTTGT
AACTAACCTCGACGCTAAG->ACTAACCTCGACGCTAAGG
AAAGGAGCAAGTCAATTAC->AAGGAGCAAGTCAATTACC
ACGATACGGTAAGTCTATC->CGATACGGTAAGTCTATCA
CGAAACCACTCGAAGGCGA->GAAACCACTCGAAGGCGAG
CGAGCCGTATTGAGTTGTG->GAGCCGTATTGAGTTGTGC
AGTCAACGAGTGGCGTACA->GTCAACGAGTGGCGTACAT
ACGGTAAGTCTATCAAACA->CGGTAAGTCTATCAAACAA
ACCTACACGAGGACATAGT->CCTACACGAGGACATAGTG
AGTGTGGTGCCAAAGCGTA->GTGTGGTGCCAAAGCGTAC
TGAATGCCGTTTGTACCTC->GAATGCCGTTTGTACCTCG
CCCGACCGCATTTGAATTC->CCGACCGCATTTGAATTCC
TTTTAAGTGGGAGCACTAC->TTTAAGTGGGAGCACTACA
CCGGTCTCCCGTTATGGAA->CGGTCTCCCGTTATGGAAT
GCATAACCCTGCTGCTTCG->CATAACCCTGCTGCTTCGT
CAAAGCCCGCCCCCGGCGT->AAAGCCCGCCCCCGGCGTT
AGCACTCGCGGGAGTGTTA->GCACTCGCGGGAGTGTTAG
CGCAAAGGGTGATCAATAA->GCAAAGGGTGATCAATAAT
TGCTTCGTTGTGGGCTTTT->GCTTCGTTGTGGGCTTTTA
AATGACGAGGCGTGTATCA->ATGACGAGGCGTGTATCAA
AGTGGAAAAGAGGGAGATC->GTGGAAAAGAGGGAGATCT
AATTATTGTCCCTTTGGTA->ATTATTGTCCCTTTGGTAA
CAGATTGCTTATTATACAG->AGATTGCTTATTATACAGC
CAGGGCGCGTTCGTTCTCT->AGGGCGCGTTCGTTCTCTT
CATGAATACTTGTTAACTA->ATGAATACTTGTTAACTAA
TGAGCTTGATTCCAATCTG->GAGCTTGATTCCAATCTGT
AGTCTACATTGGGCGAATG->GTCTACATTGGGCGAATGG
GGCGTTGCCTGAATCTTTG->GCGTTGCCTGAATCTTTGC
ACCATCCCTCTCGGCATTG->CCATCCCTCTCGGCATTGA
GGAATCCTGCATATGGAGG->GAATCCTGCATATGGAGGG
AACTATACGATGACTGCTG->ACTATACGATGACTGCTGG
GGGTCTATAAGTACGTTCC->GGTCTATAAGTACGTTCCA
CTGAATGCCGTTTGTACCT->TGAATGCCGTTTGTACCTC
AGCCCCCGTATCGGCATCA->GCCCCCGTATCGGCATCAT
CGATGCAGCAGCGGCAGCT->GATGCAGCAGCGGCAGCTG
TGAGACTATAGACTTCGTG->GAGACTATAGACTTCGTGT
TTTCTACTACCATTTCGCA->TTCTACTACCATTTCGCAA
TGGGAATATATATGCCTAC->GGGAATATATATGCCTACT
CTGCTCGATCGTTTCGCCT->TGCTCGATCGTTTCGCCTC
ATGGAAGTCCTTAATCCAA->TGGAAGTCCTTAATCCAAA
CCCTGTAGCACAAACGATA->CCTGTAGCACAAACGATAA
GTTAACTAACGATGCAGCA->TTAACTAACGATGCAGCAG
TCGCCGGCTCGAGAACTCA->CGCCGGCTCGAGAACTCAC
GTACATGCCCATCGCTGAG->TACATGCCCATCGCTGAGG
GTTAGTTGCTGCGCAGAGT->TTAGTTGCTGCGCAGAGTT
GTCGATGGACATTGCATCA->TCGATGGACATTGCATCAT
GTACGCTACAGGGCGCGTT->TACGCTACAGGGCGCGTTC
TGTTCGTGTGCCGTAGTAG->GTTCGTGTGCCGTAGTAGT
ATTAGCACTCGCGGGAGTG->TTAGCACTCGCGGGAGTGT
ATGCAGCAGCGGCAGCTGT->TGCAGCAGCGGCAGCTGTG
ATTGTAGGGAGTCAACGAG->TTGTAGGGAGTCAACGAGT
CAGCGGCGTCCGCGAGTTA->AGCGGCGTCCGCGAGTTAG
CGGGTACAAACCGAGACCA->GGGTACAAACCGAGACCAC
ACATTTAGTCTCGACCGCA->CATTTAGTCTCGACCGCAG
GCTAAGGCAGCTGTGGCAT->CTAAGGCAGCTGTGGCATT
TATAAAGGGAAACGATGCG->ATAAAGGGAAACGATGCGT
ACAGGGCGCGTTCGTTCTC->CAGGGCGCGTTCGTTCTCT
GAGTGGAAAAGAGGGAGAT->AGTGGAAAAGAGGGAGATC
TATTGTCCCTTTGGTAACC->ATTGTCCCTTTGGTAACCT
CATGGAAGTCCTTAATCCA->ATGGAAGTCCTTAATCCAA
CGATGCATCTGTTCCATGG->GATGCATCTGTTCCATGGA
CGGATCGCCGGCTCGAGAA->GGATCGCCGGCTCGAGAAC
GAGGCAGCTGTGGCATTTT->AGGCAGCTGTGGCATTTTA
TCAGAAAGAGGCAGTGTAG->CAGAAAGAGGCAGTGTAGG
GAGTAAACAGGATGGCATG->AGTAAACAGGATGGCATGG
AAGACCTACACGAGGACAT->AGACCTACACGAGGACATA
TACCTGTGGTTTGAGTCGT->ACCTGTGGTTTGAGTCGTC
CGGGCATAGCAGGATTCGG->GGGCATAGCAGGATTCGGC
AGAACAACGTTCGATCAGA->GAACAACGTTCGATCAGAA
CTTCGGTTGCTGGAGGACA->TTCGGTTGCTGGAGGACAT
ACATTGTAGGGAGTCAACG->CATTGTAGGGAGTCAACGA
AACCCGTCTGGCCTTGCCC->ACCCGTCTGGCCTTGCCCT
GAAAAGAGGGAGATCTAGC->AAAAGAGGGAGATCTAGCA
ATCAAGGGAACCTAATGGG->TCAAGGGAACCTAATGGGA
GCGAGTCGTCCATGGCCTG->CGAGTCGTCCATGGCCTGA
TTCGCAAAGGGTGATCAAT->TCGCAAAGGGTGATCAATA
ACACAAGTGTTGCACCCTA->CACAAGTGTTGCACCCTAA
GTAAACGAATACTTGTTAA->TAAACGAATACTTGTTAAC
CACTACAGCATTAGCACTC->ACTACAGCATTAGCACTCG
GCTCGATCGTTTCGCCTCT->CTCGATCGTTTCGCCTCTC
ACCTCAAGAACCCCCCGTG->CCTCAAGAACCCCCCGTGG
TGTTAACTAACTCGTCGCC->GTTAACTAACTCGTCGCCG
AAGTCGGCAGAGCGTATTT->AGTCGGCAGAGCGTATTTG
TGTCTGCCGCATTCAGCGG->GTCTGCCGCATTCAGCGGC
TTAGCCATAACGCACGCTC->TAGCCATAACGCACGCTCT
AGAAGAACAACGTTCGATC->GAAGAACAACGTTCGATCA
GGGAGTCAACGAGTGGCGT->GGAGTCAACGAGTGGCGTA
CTGTCTCACGAACGCCGTC->TGTCTCACGAACGCCGTCT
TGTGGCATTTTAATTTAGC->GTGGCATTTTAATTTAGCC
CTACCCCATTAAACCCGTC->TACCCCATTAAACCCGTCT
CGTATATACTCAACCGTCT->GTATATACTCAACCGTCTA
CTGTTCCATGGAAGTCCTT->TGTTCCATGGAAGTCCTTA
CGTGTCCTTGCAACACAAG->GTGTCCTTGCAACACAAGT
TAACGCACGCTCTTGTGTA->AACGCACGCTCTTGTGTAA
GTAGTGGAGCTCAGAACCT->TAGTGGAGCTCAGAACCTC
TTGTACCTCGCTTTATAAA->TGTACCTCGCTTTATAAAG
TCTTAGATCTTTATGTTCG->CTTAGATCTTTATGTTCGT
CCGCATTTGAATTCCTCGT->CGCATTTGAATTCCTCGTT
CCTTTGGTAACCTTCGATG->CTTTGGTAACCTTCGATGC
AGCAAGTCAATTACCGTCA->GCAAGTCAATTACCGTCAG
CTGTGGCATTTTAAAGGAG->TGTGGCATTTTAAAGGAGC
GACTGCTGGAATCCTGCAT->ACTGCTGGAATCCTGCATA
TTATCAGATATGCCCGACC->TATCAGATATGCCCGACCA
CCTACACGAGGACATAGTG->CTACACGAGGACATAGTGT
TGCATCTGTTCCATGGAAG->GCATCTGTTCCATGGAAGT
TGCCGTAGTAGTGGAGCTC->GCCGTAGTAGTGGAGCTCA
CCGCCCCCGGCGTTGGGTA->CGCCCCCGGCGTTGGGTAT
TTGCCGTCCCGACCGCATT->TGCCGTCCCGACCGCATTT
GTCTTGTCGGGTCTATAAG->TCTTGTCGGGTCTATAAGT
ACAATTAGGAGACGGTCCT->CAATTAGGAGACGGTCCTG
TTTGAAGGGTCGCTGGAAG->TTGAAGGGTCGCTGGAAGG
ACAAGTGTTGCACCCTAAC->CAAGTGTTGCACCCTAACC
CTTCGATGCTGTATAAAGA->TTCGATGCTGTATAAAGAG
GTAGTAGTGGAGCTCAGAA->TAGTAGTGGAGCTCAGAAC
CCTTCGATGCTGTATAAAG->CTTCGATGCTGTATAAAGA
AACTCGTCGCCGTAGGCAG->ACTCGTCGCCGTAGGCAGC
GGAATACTTGTTAACTAAC->GAATACTTGTTAACTAACG
AAGGGAACCTAATGGGAAT->AGGGAACCTAATGGGAATA
CCTTAATCCAAAACCCTGT->CTTAATCCAAAACCCTGTA
GTGCTTTCTACTACCATTT->TGCTTTCTACTACCATTTC
CTATAGACTTCGTGTCCTT->TATAGACTTCGTGTCCTTG
AATCCAAAACCCTGTAGCA->ATCCAAAACCCTGTAGCAC
TGCGTTGCGCGTCTGTCTC->GCGTTGCGCGTCTGTCTCA
GTGTGAGTAAGAATACTTG->TGTGAGTAAGAATACTTGT
TGATTCCAATCTGTCGAAG->GATTCCAATCTGTCGAAGT
CTTAGCATTGCCGTCCCGA->TTAGCATTGCCGTCCCGAC
GACCTACACGAGGACATAG->ACCTACACGAGGACATAGT
AAGTACGTTCCAAGCCCCC->AGTACGTTCCAAGCCCCCG
CATTTAGTCTCGACCGCAG->ATTTAGTCTCGACCGCAGA
CTCCTACCGAGCTAAGTCT->TCCTACCGAGCTAAGTCTC
CCCATCGCTGAGGAATACT->CCATCGCTGAGGAATACTT
AGTCGTCCATGGCCTGAAC->GTCGTCCATGGCCTGAACA
CTACAGGGCGCGTTCGTTC->TACAGGGCGCGTTCGTTCT
CCGCATTCAGCGGCGTCCG->CGCATTCAGCGGCGTCCGC
AACACACGGATTGAGGCAG->ACACACGGATTGAGGCAGC
AGCGTACCTGTGGTTTGAG->GCGTACCTGTGGTTTGAGT
CCCGTGGTCTTTACTTCGG->CCGTGGTCTTTACTTCGGT
TGTGGTTTGAGTCGTCGAC->GTGGTTTGAGTCGTCGACT
GCGTGGTCTTGCGCTCTTG->CGTGGTCTTGCGCTCTTGT
GTGGTGCCAAAGCGTACCT->TGGTGCCAAAGCGTACCTG
TGCCGAGTGTGAGTAAGAA->GCCGAGTGTGAGTAAGAAT
GGCATGGGCTATATACAAA->GCATGGGCTATATACAAAG
AACCTAATGGGAATATATA->ACCTAATGGGAATATATAT
GGAGCAAGTCAATTACCGT->GAGCAAGTCAATTACCGTC
GCTCAGAACCTCAAGAACC->CTCAGAACCTCAAGAACCC
GGGTCGCTGGAAGGAGCTA->GGTCGCTGGAAGGAGCTAG
AGAGTTCGAACCGGTACAT->GAGTTCGAACCGGTACATT
CATTTGCCGAGTGTGAGTA->ATTTGCCGAGTGTGAGTAA
CAGGTCGGAATACCGCCAG->AGGTCGGAATACCGCCAGC
TCAGTTCCATAGATATTGA->CAGTTCCATAGATATTGAT
CTCCTTTTGTACGCTACAG->TCCTTTTGTACGCTACAGG
AACCTGTTAGTTGCTGCGC->ACCTGTTAGTTGCTGCGCA
AAGGGTCGCTGGAAGGAGC->AGGGTCGCTGGAAGGAGCT
ACACGAAGACCTACACGAG->CACGAAGACCTACACGAGG
CGATGCTGTATAAAGAGTG->GATGCTGTATAAAGAGTGG
CTGTGGTTTGAGTCGTCGA->TGTGGTTTGAGTCGTCGAC
TCCTTAATCCAAAACCCTG->CCTTAATCCAAAACCCTGT
TCAACGAGTGGCGTACATG->CAACGAGTGGCGTACATGC
ACCCCATTAAACCCGTCTG->CCCCATTAAACCCGTCTGG
ATTGCCGTCCCGACCGCAT->TTGCCGTCCCGACCGCATT
GTCTCCCGTTATGGAATGT->TCTCCCGTTATGGAATGTA
TGTCCATCCTACGCCCTCT->GTCCATCCTACGCCCTCTC
TCGAGAACTCACGAGTCTA->CGAGAACTCACGAGTCTAC
GTCCTTAATCCAAAACCCT->TCCTTAATCCAAAACCCTG
AGGGCGCGTTCGTTCTCTT->GGGCGCGTTCGTTCTCTTA
GTTCAACTATACGATGACT->TTCAACTATACGATGACTG
CCGTCTCCGAGTCAGCTAT->CGTCTCCGAGTCAGCTATT
GTAGGGAGTCAACGAGTGG->TAGGGAGTCAACGAGTGGC
TGAGGCAGCTGTGGCATTT->GAGGCAGCTGTGGCATTTT
AGAATACTTGTTAACTAAC->GAATACTTGTTAACTAACA
CGTCGATGGACATTGCATC->GTCGATGGACATTGCATCA
CAGCGGCAGCTGTGGCATT->AGCGGCAGCTGTGGCATTT
GTTTGAGTCGTCGACTCGC->TTTGAGTCGTCGACTCGCA
ACTCTGCAGCATAACCCTG->CTCTGCAGCATAACCCTGC
AAAGAGGCAGTGTAGGCAT->AAGAGGCAGTGTAGGCATA
ATACTTGTTAACTAACACA->TACTTGTTAACTAACACAC
CCGTAGGCAGCTGTGGCAT->CGTAGGCAGCTGTGGCATT
ATCTAGCATGTCCATCCTA->TCTAGCATGTCCATCCTAC
TAGGGTCCGCCATGAGCTT->AGGGTCCGCCATGAGCTTG
AAGCGTACCTGTGGTTTGA->AGCGTACCTGTGGTTTGAG
GTGCGCCGTCTCGATGCAT->TGCGCCGTCTCGATGCATC
TGTATACTGTGTCGCGCAA->GTATACTGTGTCGCGCAAG
ACGCTAAGGCAGCTGTGGC->CGCTAAGGCAGCTGTGGCA
GGAGTGTTAGCATAGCCGG->GAGTGTTAGCATAGCCGGG
TCGGTTGCTGGAGGACATT->CGGTTGCTGGAGGACATTT
CCGGTACATTTGCCGAGTG->CGGTACATTTGCCGAGTGT
ATGTTCGTGTGCCGTAGTA->TGTTCGTGTGCCGTAGTAG
CAACGAGTGGCGTACATGC->AACGAGTGGCGTACATGCC
AGCCAGGGGTGCATCAACA->GCCAGGGGTGCATCAACAG
GAGACCACTCTGCAGCATA->AGACCACTCTGCAGCATAA
CGCCTGGTAATTATTGTCC->GCCTGGTAATTATTGTCCC
TGTAATGGGTCAGATTGCT->GTAATGGGTCAGATTGCTT
TTAGCACTCGCGGGAGTGT->TAGCACTCGCGGGAGTGTT
GGTCGGAATACCGCCAGCA->GTCGGAATACCGCCAGCAT
TATTCATGAATACTTGTTA->ATTCATGAATACTTGTTAA
GCTTTTATTTCTGAATTGT->CTTTTATTTCTGAATTGTC
GAAGGAGCTAGCACGATAC->AAGGAGCTAGCACGATACG
ATCCCTCTCGGCATTGAGA->TCCCTCTCGGCATTGAGAC
CAGAACCTCAAGAACCCCC->AGAACCTCAAGAACCCCCC
GGCTGCGCCTGGTAATTAT->GCTGCGCCTGGTAATTATT
CTCGTATATACTCAACCGT->TCGTATATACTCAACCGTC
CTTGACAGATTTCATTCAT->TTGACAGATTTCATTCATC
GCTGTGGCATTTTAAAGGA->CTGTGGCATTTTAAAGGAG
TCCTACGCCCTCTCCACCG->CCTACGCCCTCTCCACCGA
ATAACGGCAGACTAACATA->TAACGGCAGACTAACATAC
TTAGTTGCTGCGCAGAGTT->TAGTTGCTGCGCAGAGTTC
CTATATACAAAGTATCTTC->TATATACAAAGTATCTTCG
GTCCCGACCGCATTTGAAT->TCCCGACCGCATTTGAATT
TAGCATGTCCATCCTACGC->AGCATGTCCATCCTACGCC
ATCGCCGGCTCGAGAACTC->TCGCCGGCTCGAGAACTCA
CCCTCACAGTGCGCCGTCT->CCTCACAGTGCGCCGTCTC
GCCCTCTCCACCGAGCCGT->CCCTCTCCACCGAGCCGTA
CTTAATCCAAAACCCTGTA->TTAATCCAAAACCCTGTAG
GCGTCTGTCTCACGAACGC->CGTCTGTCTCACGAACGCC
CATCACTCATGGCCTTGAC->ATCACTCATGGCCTTGACG
AGAACCTCAAGAACCCCCC->GAACCTCAAGAACCCCCCG
TGTTAACTAACGATGCAGC->GTTAACTAACGATGCAGCA
TGTAGGCATACGCCCCAGC->GTAGGCATACGCCCCAGCG
TACTTGTTAACTAACGATG->ACTTGTTAACTAACGATGC
GAATTGTACCTTGTAGTGT->AATTGTACCTTGTAGTGTC
CCGACCATCCCTCTCGGCA->CGACCATCCCTCTCGGCAT
TCGAAGGCGAGTCGTCCAT->CGAAGGCGAGTCGTCCATG
ACCGTGCTACCCCATTAAA->CCGTGCTACCCCATTAAAC
TACGATGACTGCTGGAATC->ACGATGACTGCTGGAATCC
GAATACCGCCAGCATCGGG->AATACCGCCAGCATCGGGC
GCTGCGCAGAGTTCGAACC->CTGCGCAGAGTTCGAACCG
TGGCATGGGCTATATACAA->GGCATGGGCTATATACAAA
CTCTTGTGTAAACGAATAC->TCTTGTGTAAACGAATACT
GAGCTCAGAACCTCAAGAA->AGCTCAGAACCTCAAGAAC
GTTATGGAATGTAGGGTCC->TTATGGAATGTAGGGTCCG
CATTAAACCCGTCTGGCCT->ATTAAACCCGTCTGGCCTT
CAATCTGTCGAAGTCGGCA->AATCTGTCGAAGTCGGCAG
ACCTAATGGGAATATATAT->CCTAATGGGAATATATATG
GCGTACCTGTGGTTTGAGT->CGTACCTGTGGTTTGAGTC
TGTTGCACCCTAACCTGTT->GTTGCACCCTAACCTGTTA
TACATTGGGCGAATGGACA->ACATTGGGCGAATGGACAT
TTTATGTTCGTGTGCCGTA->TTATGTTCGTGTGCCGTAG
ATCCAAAACCCTGTAGCAC->TCCAAAACCCTGTAGCACA
GTTAGCATAGCCGGGGGAT->TTAGCATAGCCGGGGGATT
AAACGGGTACAAACCGAGA->AACGGGTACAAACCGAGAC
TCCAATCTGTCGAAGTCGG->CCAATCTGTCGAAGTCGGC
TTATACAGCCAGAAGAACA->TATACAGCCAGAAGAACAA
TTAAGTGGGAGCACTACAG->TAAGTGGGAGCACTACAGC
GACGCTAAGGCAGCTGTGG->ACGCTAAGGCAGCTGTGGC
GCACCCTAACCTGTTAGTT->CACCCTAACCTGTTAGTTG
GGGCGCGTTCGTTCTCTTA->GGCGCGTTCGTTCTCTTAG
TCGGCATCATCATTTCTTA->CGGCATCATCATTTCTTAG
TCAGATATGCCCGACCATC->CAGATATGCCCGACCATCC
GCCCGCCCCCGGCGTTGGG->CCCGCCCCCGGCGTTGGGT
CTCGGGCATAGCAGGATTC->TCGGGCATAGCAGGATTCG
CCTACGCCCTCTCCACCGA->CTACGCCCTCTCCACCGAG
TTCGGCCACAAATACGGAG->TCGGCCACAAATACGGAGA
GGATCGCCGGCTCGAGAAC->GATCGCCGGCTCGAGAACT
AAGGCGAGTCGTCCATGGC->AGGCGAGTCGTCCATGGCC
CTAGTCTTGGACGACGGAT->TAGTCTTGGACGACGGATC
GGGGATTTGAAGGGTCGCT->GGGATTTGAAGGGTCGCTG
ACTCACGAGTCTACATTGG->CTCACGAGTCTACATTGGG
GCGCAGTGTGCTTTCTACT->CGCAGTGTGCTTTCTACTA
CATAGCAGGATTCGGCTTG->ATAGCAGGATTCGGCTTGA
CTGTATAAAGAGTGGAAAA->TGTATAAAGAGTGGAAAAG
ACCACTCTGCAGCATAACC->CCACTCTGCAGCATAACCC
GATATTGATCGTGCAAGGT->ATATTGATCGTGCAAGGTC
GGGCTATATACAAAGTATC->GGCTATATACAAAGTATCT
TGGCATTTTAAGTGGGAGC->GGCATTTTAAGTGGGAGCA
ACTTGTTAACTAACGATGC->CTTGTTAACTAACGATGCA
GACGACGGATCGCCGGCTC->ACGACGGATCGCCGGCTCG
GGCCTTGACGGCAAGCGAA->GCCTTGACGGCAAGCGAAA
TGGGTCAGATTGCTTATTA->GGGTCAGATTGCTTATTAT
TGTCCCTTTGGTAACCTTC->GTCCCTTTGGTAACCTTCG
AGCTAGCACGATACGGTAA->GCTAGCACGATACGGTAAG
CGATAACGGCAGACTAACA->GATAACGGCAGACTAACAT
GCATTTTAAGTGGGAGCAC->CATTTTAAGTGGGAGCACT
GAATTCCTCGTTCAACTAT->AATTCCTCGTTCAACTATA
CGAACGCCGTCTCCGAGTC->GAACGCCGTCTCCGAGTCA
AGAACTCACGAGTCTACAT->GAACTCACGAGTCTACATT
TCAAGAACCCCCCGTGGTC->CAAGAACCCCCCGTGGTCT
ATGACTGCTGGAATCCTGC->TGACTGCTGGAATCCTGCA
CATTAGCACTCGCGGGAGT->ATTAGCACTCGCGGGAGTG
AATGAAAAATGACGAGGCG->ATGAAAAATGACGAGGCGT
GGTGCCAAAGCGTACCTGT->GTGCCAAAGCGTACCTGTG
AGAGGGAGATCTAGCATGT->GAGGGAGATCTAGCATGTC
TGAGGAATACTTGTTAACT->GAGGAATACTTGTTAACTA
GTGGAGCTCAGAACCTCAA->TGGAGCTCAGAACCTCAAG
GCAGACACGTCGCCCTCCT->CAGACACGTCGCCCTCCTA
ACCGCAGAACTGAGTAAAC->CCGCAGAACTGAGTAAACA
TGTCTCACGAACGCCGTCT->GTCTCACGAACGCCGTCTC
AAAGTATCTTCGGCCACAA->AAGTATCTTCGGCCACAAA
GAATTGTCTGCCGCATTCA->AATTGTCTGCCGCATTCAG
AACAAAGCCCGCCCCCGGC->ACAAAGCCCGCCCCCGGCG
ACTTGTTAACTAACACACG->CTTGTTAACTAACACACGG
TCAGCTATTCATGAATACT->CAGCTATTCATGAATACTT
CCTTGACGGCAAGCGAAAC->CTTGACGGCAAGCGAAACC
AAGATTATTACCGACCGTG->AGATTATTACCGACCGTGC
CCAATCTGTCGAAGTCGGC->CAATCTGTCGAAGTCGGCA
CATACGCCCCAGCGCGTCG->ATACGCCCCAGCGCGTCGA
GCTTCGTTGTGGGCTTTTA->CTTCGTTGTGGGCTTTTAT
ACGCTCTTGTGTAAACGAA->CGCTCTTGTGTAAACGAAT
CGCTCTTGTATACTGTGTC->GCTCTTGTATACTGTGTCG
GAGCTTGATTCCAATCTGT->AGCTTGATTCCAATCTGTC
TCGTTGTGGGCTTTTATTT->CGTTGTGGGCTTTTATTTC
CCTACTCCTTTTGTACGCT->CTACTCCTTTTGTACGCTA
ATGGCATGGGCTATATACA->TGGCATGGGCTATATACAA
AACCGAGACCACTCTGCAG->ACCGAGACCACTCTGCAGC
TGAATTCCTCGTTCAACTA->GAATTCCTCGTTCAACTAT
CCCTAACCTGTTAGTTGCT->CCTAACCTGTTAGTTGCTG
GCAGGATTCGGCTTGACAG->CAGGATTCGGCTTGACAGA
CCATGGCCTGAACACGAAG->CATGGCCTGAACACGAAGA
CACCCCGTCCGCAGACACG->ACCCCGTCCGCAGACACGT
CGTCAGAAGGCTCCTCAGG->GTCAGAAGGCTCCTCAGGC
ATGGAATGTAGGGTCCGCC->TGGAATGTAGGGTCCGCCA
CGTTCGTTCTCTTAGGCAG->GTTCGTTCTCTTAGGCAGG
AGCGTATTTGCAGTAAGAT->GCGTATTTGCAGTAAGATT
TACAAAGTATCTTCGGCCA->ACAAAGTATCTTCGGCCAC
TCATCACTCATGGCCTTGA->CATCACTCATGGCCTTGAC
AAACACCCCGTCCGCAGAC->AACACCCCGTCCGCAGACA
GCAGTGTGCTTTCTACTAC->CAGTGTGCTTTCTACTACC
TTTAAGTGGGAGCACTACA->TTAAGTGGGAGCACTACAG
ATCACTCATGGCCTTGACG->TCACTCATGGCCTTGACGG
CCACAAATACGGAGAAACA->CACAAATACGGAGAAACAC
TCTGTCGAAGTCGGCAGAG->CTGTCGAAGTCGGCAGAGC
GTCTTAGCATTGCCGTCCC->TCTTAGCATTGCCGTCCCG
ACTGAGTAAACAGGATGGC->CTGAGTAAACAGGATGGCA
CGTAGTAGTGGAGCTCAGA->GTAGTAGTGGAGCTCAGAA
AGAGTGGAAAAGAGGGAGA->GAGTGGAAAAGAGGGAGAT
CGTCGACTCGCATTCTGCT->GTCGACTCGCATTCTGCTC
GCTATATACAAAGTATCTT->CTATATACAAAGTATCTTC
GCGAGTTAGCCGAATTGTA->CGAGTTAGCCGAATTGTAC
ATTCATCTGCTCGATCGTT->TTCATCTGCTCGATCGTTT
TACCCCATTAAACCCGTCT->ACCCCATTAAACCCGTCTG
GCAAAGGGTGATCAATAAT->CAAAGGGTGATCAATAATG
CTGCGCAGAGTTCGAACCG->TGCGCAGAGTTCGAACCGG
CAGCCAGGGGTGCATCAAC->AGCCAGGGGTGCATCAACA
TGAACACGAAGACCTACAC->GAACACGAAGACCTACACG
TTCGTTCTCTTAGGCAGGT->TCGTTCTCTTAGGCAGGTC
AGTGGGAGCACTACAGCAT->GTGGGAGCACTACAGCATT
CTGAGGAATACTTGTTAAC->TGAGGAATACTTGTTAACT
TAACCTGTTAGTTGCTGCG->AACCTGTTAGTTGCTGCGC
TTCTTAGATCTTTATGTTC->TCTTAGATCTTTATGTTCG
AATACGGAGAAACACCCCG->ATACGGAGAAACACCCCGT
AACAGGATGGCATGGGCTA->ACAGGATGGCATGGGCTAT
TCGTTTCGCCTCTCAAATG->CGTTTCGCCTCTCAAATGT
TATATGCCTACTCCTTTTG->ATATGCCTACTCCTTTTGT
ACTAAAGTGGCCGCCTGAA->CTAAAGTGGCCGCCTGAAT
GCTGTATAAAGAGTGGAAA->CTGTATAAAGAGTGGAAAA
TGCGTGGTCTTGCGCTCTT->GCGTGGTCTTGCGCTCTTG
TACTGTGTCGCGCAAGCCA->ACTGTGTCGCGCAAGCCAG
AAGTGTTGCACCCTAACCT->AGTGTTGCACCCTAACCTG
GGACATTGTAGGGAGTCAA->GACATTGTAGGGAGTCAAC
ATCCTACGCCCTCTCCACC->TCCTACGCCCTCTCCACCG
TCGAACCGGTACATTTGCC->CGAACCGGTACATTTGCCG
TATCTTCGGCCACAAATAC->ATCTTCGGCCACAAATACG
AGAGGCAGTGTAGGCATAC->GAGGCAGTGTAGGCATACG
AGTCTATCAAACAATTAGG->GTCTATCAAACAATTAGGA
AGCACTACAGCATTAGCAC->GCACTACAGCATTAGCACT
GTGGTTTGAGTCGTCGACT->TGGTTTGAGTCGTCGACTC
CTCACGAACGCCGTCTCCG->TCACGAACGCCGTCTCCGA
GGAGCTCAGAACCTCAAGA->GAGCTCAGAACCTCAAGAA
TGCTGTATAAAGAGTGGAA->GCTGTATAAAGAGTGGAAA
ATCTTTATGTTCGTGTGCC->TCTTTATGTTCGTGTGCCG
TGTATCAAGGGAACCTAAT->GTATCAAGGGAACCTAATG
TGTGGGCTTTTATTTCTGA->GTGGGCTTTTATTTCTGAA
GCCGCATTCAGCGGCGTCC->CCGCATTCAGCGGCGTCCG
GTATAAAGAGTGGAAAAGA->TATAAAGAGTGGAAAAGAG
AATCCTGCATATGGAGGGG->ATCCTGCATATGGAGGGGC
AAGCCAGAACAAAGCCCGC->AGCCAGAACAAAGCCCGCC
TGTGTAAACGAATACTTGT->GTGTAAACGAATACTTGTT
TGCTGCTTCGTTGTGGGCT->GCTGCTTCGTTGTGGGCTT
CGTGTGCCGTAGTAGTGGA->GTGTGCCGTAGTAGTGGAG
CGTCTCGATGCATCTGTTC->GTCTCGATGCATCTGTTCC
ATCATCATTTCTTAGATCT->TCATCATTTCTTAGATCTT
CGAATGGACATTGTAGGGA->GAATGGACATTGTAGGGAG
GTCCTTGCAACACAAGTGT->TCCTTGCAACACAAGTGTT
ACATAGTGTGGTGCCAAAG->CATAGTGTGGTGCCAAAGC
AGCATCGGGCGTTGCCTGA->GCATCGGGCGTTGCCTGAA
GCTCGTATATACTCAACCG->CTCGTATATACTCAACCGT
ATTGGGCGAATGGACATTG->TTGGGCGAATGGACATTGT
GCATTTGAATTCCTCGTTC->CATTTGAATTCCTCGTTCA
AGTCAGCTATTCATGAATA->GTCAGCTATTCATGAATAC
TCTACTACCATTTCGCAAA->CTACTACCATTTCGCAAAG
TTATTGTCCCTTTGGTAAC->TATTGTCCCTTTGGTAACC
GGTCTTTACTTCGGTTGCT->GTCTTTACTTCGGTTGCTG
AGATTGCTTATTATACAGC->GATTGCTTATTATACAGCC
GCGAAACCACTCGAAGGCG->CGAAACCACTCGAAGGCGA
TAACTAACACACGGATTGA->AACTAACACACGGATTGAG
ACCGAGACCACTCTGCAGC->CCGAGACCACTCTGCAGCA
CTCAGGCTGCGCCTGGTAA->TCAGGCTGCGCCTGGTAAT
GATGGCATGGGCTATATAC->ATGGCATGGGCTATATACA
ACAGTCTTGTCGGGTCTAT->CAGTCTTGTCGGGTCTATA
CGCTTTATAAAGGGAAACG->GCTTTATAAAGGGAAACGA
CATCATTTCTTAGATCTTT->ATCATTTCTTAGATCTTTA
CTCAACCGTCTAGTCTTGG->TCAACCGTCTAGTCTTGGA
GCATGGGCTATATACAAAG->CATGGGCTATATACAAAGT
AACTCACGAGTCTACATTG->ACTCACGAGTCTACATTGG
CACAAGTGTTGCACCCTAA->ACAAGTGTTGCACCCTAAC
AGGTCGGAATACCGCCAGC->GGTCGGAATACCGCCAGCA
CCACTCGAAGGCGAGTCGT->CACTCGAAGGCGAGTCGTC
CGGCAGACTAACATACTAA->GGCAGACTAACATACTAAA
TTGACGGCAAGCGAAACCA->TGACGGCAAGCGAAACCAC
GCATAGCCGGGGGATTTGA->CATAGCCGGGGGATTTGAA
AATACTTGTTAACTAACGA->ATACTTGTTAACTAACGAT
GTGAGTAAGAATACTTGTT->TGAGTAAGAATACTTGTTA
TGGAGCTCAGAACCTCAAG->GGAGCTCAGAACCTCAAGA
TGTACCTCGCTTTATAAAG->GTACCTCGCTTTATAAAGG
GCCCATCGCTGAGGAATAC->CCCATCGCTGAGGAATACT
GCAAACGGGTACAAACCGA->CAAACGGGTACAAACCGAG
CGTGCAAGGTCACAGCCAG->GTGCAAGGTCACAGCCAGG
AAGCCCGCCCCCGGCGTTG->AGCCCGCCCCCGGCGTTGG
CTTGTCGGGTCTATAAGTA->TTGTCGGGTCTATAAGTAC
GCAGCGGCAGCTGTGGCAT->CAGCGGCAGCTGTGGCATT
TTTGAATTCCTCGTTCAAC->TTGAATTCCTCGTTCAACT
CGTCGCCCTCCTACCGAGC->GTCGCCCTCCTACCGAGCT
CGTGTATCAAGGGAACCTA->GTGTATCAAGGGAACCTAA
CGCCGTCTCCGAGTCAGCT->GCCGTCTCCGAGTCAGCTA
ATTGAGTTGTGCTGCAAAC->TTGAGTTGTGCTGCAAACG
GCGTTCGTTCTCTTAGGCA->CGTTCGTTCTCTTAGGCAG
GTATCAAGGGAACCTAATG->TATCAAGGGAACCTAATGG
ATCGGGCGTTGCCTGAATC->TCGGGCGTTGCCTGAATCT
CTCTTAGGCAGGTCGGAAT->TCTTAGGCAGGTCGGAATA
ACGGATCGCCGGCTCGAGA->CGGATCGCCGGCTCGAGAA
GCAAGCGAAACCACTCGAA->CAAGCGAAACCACTCGAAG
TGACGAGGCGTGTATCAAG->GACGAGGCGTGTATCAAGG
TGTGGCATTTTAAAGCGAC->GTGGCATTTTAAAGCGACT
CCCTCTCCACCGAGCCGTA->CCTCTCCACCGAGCCGTAT
GGAGATCTAGCATGTCCAT->GAGATCTAGCATGTCCATC
CGTGCTACCCCATTAAACC->GTGCTACCCCATTAAACCC
GGGTGCGTAATTGAGGACT->GGTGCGTAATTGAGGACTT
TTATTATACAGCCAGAAGA->TATTATACAGCCAGAAGAA
TTTCTTAGATCTTTATGTT->TTCTTAGATCTTTATGTTC
ACAAATACGGAGAAACACC->CAAATACGGAGAAACACCC
ATGCCCGACCATCCCTCTC->TGCCCGACCATCCCTCTCG
GAAGGCGAGTCGTCCATGG->AAGGCGAGTCGTCCATGGC
CCCCGTCCGCAGACACGTC->CCCGTCCGCAGACACGTCG
TTTATTTCTGAATTGTCTG->TTATTTCTGAATTGTCTGC
CGACCGCAGAACTGAGTAA->GACCGCAGAACTGAGTAAA
AGGCGTGTATCAAGGGAAC->GGCGTGTATCAAGGGAACC
TGTGGTGCCAAAGCGTACC->GTGGTGCCAAAGCGTACCT
TTGCAGTAAGATTATTACC->TGCAGTAAGATTATTACCG
CTTTATCAGATATGCCCGA->TTTATCAGATATGCCCGAC
TATGCCTACTCCTTTTGTA->ATGCCTACTCCTTTTGTAC
AGGAATACTTGTTAACTAA->GGAATACTTGTTAACTAAC
GGTCCGCCATGAGCTTGAT->GTCCGCCATGAGCTTGATT
CAATTACCGTCAGAAGGCT->AATTACCGTCAGAAGGCTC
GCAACACAAGTGTTGCACC->CAACACAAGTGTTGCACCC
GTTCCATAGATATTGATCG->TTCCATAGATATTGATCGT
GGCGTGTATCAAGGGAACC->GCGTGTATCAAGGGAACCT
TAGCCGGGGGATTTGAAGG->AGCCGGGGGATTTGAAGGG
CCAAAACCCTGTAGCACAA->CAAAACCCTGTAGCACAAA
CGTTATGGAATGTAGGGTC->GTTATGGAATGTAGGGTCC
CACGAGTCTACATTGGGCG->ACGAGTCTACATTGGGCGA
TGTTAGCATAGCCGGGGGA->GTTAGCATAGCCGGGGGAT
GCTTATTATACAGCCAGAA->CTTATTATACAGCCAGAAG
ACCCTAACCTGTTAGTTGC->CCCTAACCTGTTAGTTGCT
ATTCTGCTCGTATATACTC->TTCTGCTCGTATATACTCA
TTAACTAACCTCGACGCTA->TAACTAACCTCGACGCTAA
GGTGCGTAATTGAGGACTT->GTGCGTAATTGAGGACTTC
CACACGGATTGAGGCAGCT->ACACGGATTGAGGCAGCTG
CCTTGTAGTGTCTTAGCAT->CTTGTAGTGTCTTAGCATT
TAGTCTTGGACGACGGATC->AGTCTTGGACGACGGATCG
TACGCCCTCTCCACCGAGC->ACGCCCTCTCCACCGAGCC
CGTGGTCTTGCGCTCTTGT->GTGGTCTTGCGCTCTTGTA
GAACACGAAGACCTACACG->AACACGAAGACCTACACGA
GGTCACAGCCAGGGGTGCA->GTCACAGCCAGGGGTGCAT
TATACGATGACTGCTGGAA->ATACGATGACTGCTGGAAT
TACTTGTTAACTAACTCGT->ACTTGTTAACTAACTCGTC
AGTCAATTACCGTCAGAAG->GTCAATTACCGTCAGAAGG
ATGGGTCAGATTGCTTATT->TGGGTCAGATTGCTTATTA
CCGTAGTAGTGGAGCTCAG->CGTAGTAGTGGAGCTCAGA
TGATCAATAATGAAAAATG->GATCAATAATGAAAAATGA
TTGTACCTTGTAGTGTCTT->TGTACCTTGTAGTGTCTTA
TCATTTCTTAGATCTTTAT->CATTTCTTAGATCTTTATG
CGAGTGTGAGTAAGAATAC->GAGTGTGAGTAAGAATACT
ATATACAAAGTATCTTCGG->TATACAAAGTATCTTCGGC
ACTCGCATTCTGCTCGTAT->CTCGCATTCTGCTCGTATA
CGCCATGAGCTTGATTCCA->GCCATGAGCTTGATTCCAA
CCTGAACACGAAGACCTAC->CTGAACACGAAGACCTACA
TCCCCTCGGGCATAGCAGG->CCCCTCGGGCATAGCAGGA
GCCGGGGGATTTGAAGGGT->CCGGGGGATTTGAAGGGTC
TTTTGTACGCTACAGGGCG->TTTGTACGCTACAGGGCGC
ACCTGTGGTTTGAGTCGTC->CCTGTGGTTTGAGTCGTCG
CTACATTGGGCGAATGGAC->TACATTGGGCGAATGGACA
GTATCGGCATCATCATTTC->TATCGGCATCATCATTTCT
AACCCTGCTGCTTCGTTGT->ACCCTGCTGCTTCGTTGTG
TGCCGTTTGTACCTCGCTT->GCCGTTTGTACCTCGCTTT
CGACTCGTCAGTTCCATAG->GACTCGTCAGTTCCATAGA
GAATGTAGGGTCCGCCATG->AATGTAGGGTCCGCCATGA
AGATATTGATCGTGCAAGG->GATATTGATCGTGCAAGGT
CAGAGTTCGAACCGGTACA->AGAGTTCGAACCGGTACAT
CAGGATTCGGCTTGACAGA->AGGATTCGGCTTGACAGAT
TACCGCCAGCATCGGGCGT->ACCGCCAGCATCGGGCGTT
AGGCAGGTCGGAATACCGC->GGCAGGTCGGAATACCGCC
GTAATGGGTCAGATTGCTT->TAATGGGTCAGATTGCTTA
TCTCGATGCATCTGTTCCA->CTCGATGCATCTGTTCCAT
GGAAACGATGCGTGGTCTT->GAAACGATGCGTGGTCTTG
TCCATCCTACGCCCTCTCC->CCATCCTACGCCCTCTCCA
ACCGTCAGAAGGCTCCTCA->CCGTCAGAAGGCTCCTCAG
CAACTATACGATGACTGCT->AACTATACGATGACTGCTG
TATACTCAACCGTCTAGTC->ATACTCAACCGTCTAGTCT
GACCGCAGAACTGAGTAAA->ACCGCAGAACTGAGTAAAC
TCCAAAACCCTGTAGCACA->CCAAAACCCTGTAGCACAA
CGGGGGATTTGAAGGGTCG->GGGGGATTTGAAGGGTCGC
GTAATTATTGTCCCTTTGG->TAATTATTGTCCCTTTGGT
ACGATAACGGCAGACTAAC->CGATAACGGCAGACTAACA
TATGCGTTGCGCGTCTGTC->ATGCGTTGCGCGTCTGTCT
GCCGAGTGTGAGTAAGAAT->CCGAGTGTGAGTAAGAATA
CTTGACGGCAAGCGAAACC->TTGACGGCAAGCGAAACCA
GACGGCAAGCGAAACCACT->ACGGCAAGCGAAACCACTC
CATACTAAAGTGGCCGCCT->ATACTAAAGTGGCCGCCTG
ACCGTCTAGTCTTGGACGA->CCGTCTAGTCTTGGACGAC
TGGGAGCACTACAGCATTA->GGGAGCACTACAGCATTAG
CGCCTCTCAAATGTATTGA->GCCTCTCAAATGTATTGAT
CTATAAGTACGTTCCAAGC->TATAAGTACGTTCCAAGCC
GTGTGGTGCCAAAGCGTAC->TGTGGTGCCAAAGCGTACC
TTGTAGTGTCTTAGCATTG->TGTAGTGTCTTAGCATTGC
AATGTATTGATCTCCTGGG->ATGTATTGATCTCCTGGGT
AGGGTCCGCCATGAGCTTG->GGGTCCGCCATGAGCTTGA
GGCATAGCAGGATTCGGCT->GCATAGCAGGATTCGGCTT
GGTCCTGATCTATTGTAAT->GTCCTGATCTATTGTAATG
AGTTCGAACCGGTACATTT->GTTCGAACCGGTACATTTG
ACGCTACAGGGCGCGTTCG->CGCTACAGGGCGCGTTCGT
CACGTCGCCCTCCTACCGA->ACGTCGCCCTCCTACCGAG
CGAGACCACTCTGCAGCAT->GAGACCACTCTGCAGCATA
CCCCATTAAACCCGTCTGG->CCCATTAAACCCGTCTGGC
CCAGAACAAAGCCCGCCCC->CAGAACAAAGCCCGCCCCC
GCGTTGGGTATGCGTTGCG->CGTTGGGTATGCGTTGCGC
TGAGTAAACAGGATGGCAT->GAGTAAACAGGATGGCATG
TGCTCCCCTCGGGCATAGC->GCTCCCCTCGGGCATAGCA
GTGCAAGGTCACAGCCAGG->TGCAAGGTCACAGCCAGGG
ATAAAGGGAAACGATGCGT->TAAAGGGAAACGATGCGTG
AAAGCGTACCTGTGGTTTG->AAGCGTACCTGTGGTTTGA
TAACATACTAAAGTGGCCG->AACATACTAAAGTGGCCGC
TTCGATCAGAAAGAGGCAG->TCGATCAGAAAGAGGCAGT
TTCGGTTGCTGGAGGACAT->TCGGTTGCTGGAGGACATT
AAAGGGAAACGATGCGTGG->AAGGGAAACGATGCGTGGT
CCCGTATCGGCATCATCAT->CCGTATCGGCATCATCATT
AGCATGTCCATCCTACGCC->GCATGTCCATCCTACGCCC
GTTCCGGTCTCCCGTTATG->TTCCGGTCTCCCGTTATGG
AACCCTGTAGCACAAACGA->ACCCTGTAGCACAAACGAT
GCCGTAGGCAGCTGTGGCA->CCGTAGGCAGCTGTGGCAT
CGTCAGTTCCATAGATATT->GTCAGTTCCATAGATATTG
CCCTGCTGCTTCGTTGTGG->CCTGCTGCTTCGTTGTGGG
TCGTCGCCGTAGGCAGCTG->CGTCGCCGTAGGCAGCTGT
GTCTATCAAACAATTAGGA->TCTATCAAACAATTAGGAG
AAGGAGCTAGCACGATACG->AGGAGCTAGCACGATACGG
TAGGGAGTCAACGAGTGGC->AGGGAGTCAACGAGTGGCG
TCTGCTCGTATATACTCAA->CTGCTCGTATATACTCAAC
CTTGCCCTCACAGTGCGCC->TTGCCCTCACAGTGCGCCG
TGTTAACTAACACACGGAT->GTTAACTAACACACGGATT
TGTCCTTGCAACACAAGTG->GTCCTTGCAACACAAGTGT
ATATATATGCCTACTCCTT->TATATATGCCTACTCCTTT
GCGTACATGCCCATCGCTG->CGTACATGCCCATCGCTGA
TTGGGTATGCGTTGCGCGT->TGGGTATGCGTTGCGCGTC
AGTGGAGCTCAGAACCTCA->GTGGAGCTCAGAACCTCAA
ATTTCATTCATCTGCTCGA->TTTCATTCATCTGCTCGAT
AACTAACGATGCAGCAGCG->ACTAACGATGCAGCAGCGG
CACGCTCTTGTGTAAACGA->ACGCTCTTGTGTAAACGAA
ACGAGGACATAGTGTGGTG->CGAGGACATAGTGTGGTGC
ATCGTGCAAGGTCACAGCC->TCGTGCAAGGTCACAGCCA
CGGGCGTTGCCTGAATCTT->GGGCGTTGCCTGAATCTTT
CCCCCCGTGGTCTTTACTT->CCCCCGTGGTCTTTACTTC
TAAACAGGATGGCATGGGC->AAACAGGATGGCATGGGCT
TCCTTTATCAGATATGCCC->CCTTTATCAGATATGCCCG
ATAGTGTGGTGCCAAAGCG->TAGTGTGGTGCCAAAGCGT
CACAAATACGGAGAAACAC->ACAAATACGGAGAAACACC
TTGTACGCTACAGGGCGCG->TGTACGCTACAGGGCGCGT
ACCCGTCTGGCCTTGCCCT->CCCGTCTGGCCTTGCCCTC
CCAAAGCGTACCTGTGGTT->CAAAGCGTACCTGTGGTTT
TTGCATCATCACTCATGGC->TGCATCATCACTCATGGCC
GTCGGAATACCGCCAGCAT->TCGGAATACCGCCAGCATC
GTCACAGCCAGGGGTGCAT->TCACAGCCAGGGGTGCATC
ACCCCCCGTGGTCTTTACT->CCCCCCGTGGTCTTTACTT
GGGTGCATCAACAGTCTTG->GGTGCATCAACAGTCTTGT
TCCTCGTTCAACTATACGA->CCTCGTTCAACTATACGAT
TCGGGCGTTGCCTGAATCT->CGGGCGTTGCCTGAATCTT
GCACGATACGGTAAGTCTA->CACGATACGGTAAGTCTAT
GGAAGTCCTTAATCCAAAA->GAAGTCCTTAATCCAAAAC
CTGGAAGGAGCTAGCACGA->TGGAAGGAGCTAGCACGAT
TAACTAACCTCGACGCTAA->AACTAACCTCGACGCTAAG
AGCTGTGGCATTTTAAAGG->GCTGTGGCATTTTAAAGGA
ACCGAGCTAAGTCTCCTTT->CCGAGCTAAGTCTCCTTTA
TTCGCCTCTCAAATGTATT->TCGCCTCTCAAATGTATTG
CCGCAGACACGTCGCCCTC->CGCAGACACGTCGCCCTCC
CATAACCCTGCTGCTTCGT->ATAACCCTGCTGCTTCGTT
TTTGAGTCGTCGACTCGCA->TTGAGTCGTCGACTCGCAT
GAGTTCGAACCGGTACATT->AGTTCGAACCGGTACATTT
AATGTAGGGTCCGCCATGA->ATGTAGGGTCCGCCATGAG
CTCCTCAGGCTGCGCCTGG->TCCTCAGGCTGCGCCTGGT
ATGCGTTGCGCGTCTGTCT->TGCGTTGCGCGTCTGTCTC
AAACCGAGACCACTCTGCA->AACCGAGACCACTCTGCAG
CGGATTGAGGCAGCTGTGG->GGATTGAGGCAGCTGTGGC
CCGTATTGAGTTGTGCTGC->CGTATTGAGTTGTGCTGCA
ATTCAGCGGCGTCCGCGAG->TTCAGCGGCGTCCGCGAGT
CAACAGTCTTGTCGGGTCT->AACAGTCTTGTCGGGTCTA
GCAGACTAACATACTAAAG->CAGACTAACATACTAAAGT
CCGAATTGTACCTTGTAGT->CGAATTGTACCTTGTAGTG
GGAGTCAACGAGTGGCGTA->GAGTCAACGAGTGGCGTAC
ACGGTCCTGATCTATTGTA->CGGTCCTGATCTATTGTAA
GAGTGTTAGCATAGCCGGG->AGTGTTAGCATAGCCGGGG
CATGAGCTTGATTCCAATC->ATGAGCTTGATTCCAATCT
AGTGTCTTAGCATTGCCGT->GTGTCTTAGCATTGCCGTC
CGCTACAGGGCGCGTTCGT->GCTACAGGGCGCGTTCGTT
TAACTAACGATGCAGCAGC->AACTAACGATGCAGCAGCG
GCATAGCAGGATTCGGCTT->CATAGCAGGATTCGGCTTG
GGAATGTAGGGTCCGCCAT->GAATGTAGGGTCCGCCATG
TCTCCTTTATCAGATATGC->CTCCTTTATCAGATATGCC
GTGGCATTTTAAGTGGGAG->TGGCATTTTAAGTGGGAGC
TTGAGGCAGCTGTGGCATT->TGAGGCAGCTGTGGCATTT
AACACCCCGTCCGCAGACA->ACACCCCGTCCGCAGACAC
CGGCGTTGGGTATGCGTTG->GGCGTTGGGTATGCGTTGC
TGAATACTTGTTAACTAAC->GAATACTTGTTAACTAACT
GCTGGAGGACATTTAGTCT->CTGGAGGACATTTAGTCTC
ACGACGGATCGCCGGCTCG->CGACGGATCGCCGGCTCGA
GTATCTTCGGCCACAAATA->TATCTTCGGCCACAAATAC
ACGGCAGACTAACATACTA->CGGCAGACTAACATACTAA
CTAACGATGCAGCAGCGGC->TAACGATGCAGCAGCGGCA
CAGCATTAGCACTCGCGGG->AGCATTAGCACTCGCGGGA
CGTAGGCAGCTGTGGCATT->GTAGGCAGCTGTGGCATTT
TTCCAATCTGTCGAAGTCG->TCCAATCTGTCGAAGTCGG
TCTTGCGCTCTTGTATACT->CTTGCGCTCTTGTATACTG
GTTGGGTATGCGTTGCGCG->TTGGGTATGCGTTGCGCGT
GTGCATCAACAGTCTTGTC->TGCATCAACAGTCTTGTCG
GCCTCTCAAATGTATTGAT->CCTCTCAAATGTATTGATC
TTTCTGAATTGTCTGCCGC->TTCTGAATTGTCTGCCGCA
CTCGATGCATCTGTTCCAT->TCGATGCATCTGTTCCATG
GTTAACTAACACACGGATT->TTAACTAACACACGGATTG
TAGTGGAGCTCAGAACCTC->AGTGGAGCTCAGAACCTCA
TGCGCCGTCTCGATGCATC->GCGCCGTCTCGATGCATCT
TCGGGTCTATAAGTACGTT->CGGGTCTATAAGTACGTTC
AGTAGTGGAGCTCAGAACC->GTAGTGGAGCTCAGAACCT
ACACGAGGACATAGTGTGG->CACGAGGACATAGTGTGGT
CGGCAGAGCGTATTTGCAG->GGCAGAGCGTATTTGCAGT
CCCTCCTACCGAGCTAAGT->CCTCCTACCGAGCTAAGTC
ATTTTAATTTAGCCATAAC->TTTTAATTTAGCCATAACG
TCTACATTGGGCGAATGGA->CTACATTGGGCGAATGGAC
TAGTCTCGACCGCAGAACT->AGTCTCGACCGCAGAACTG
GCCGTCTCGATGCATCTGT->CCGTCTCGATGCATCTGTT
TTTAGCCATAACGCACGCT->TTAGCCATAACGCACGCTC
CTCCGAGTCAGCTATTCAT->TCCGAGTCAGCTATTCATG
CGAATACTTGTTAACTAAC->GAATACTTGTTAACTAACC
GACATAGTGTGGTGCCAAA->ACATAGTGTGGTGCCAAAG
GAGTCGTCGACTCGCATTC->AGTCGTCGACTCGCATTCT
CCTGATCTATTGTAATGGG->CTGATCTATTGTAATGGGT
TATACTGTGTCGCGCAAGC->ATACTGTGTCGCGCAAGCC
TCGCGGGAGTGTTAGCATA->CGCGGGAGTGTTAGCATAG
TCTCCACCGAGCCGTATTG->CTCCACCGAGCCGTATTGA
GCATCAACAGTCTTGTCGG->CATCAACAGTCTTGTCGGG
TAGTGTGGTGCCAAAGCGT->AGTGTGGTGCCAAAGCGTA
ATACTCAACCGTCTAGTCT->TACTCAACCGTCTAGTCTT
TCGGAATACCGCCAGCATC->CGGAATACCGCCAGCATCG
GAGCAAGTCAATTACCGTC->AGCAAGTCAATTACCGTCA
AAATGACGAGGCGTGTATC->AATGACGAGGCGTGTATCA
CAAACCGAGACCACTCTGC->AAACCGAGACCACTCTGCA
GTTGCGCGTCTGTCTCACG->TTGCGCGTCTGTCTCACGA
TGTCGGGTCTATAAGTACG->GTCGGGTCTATAAGTACGT
TCTTGTCGGGTCTATAAGT->CTTGTCGGGTCTATAAGTA
CGAGTCTACATTGGGCGAA->GAGTCTACATTGGGCGAAT
GGCAAGCGAAACCACTCGA->GCAAGCGAAACCACTCGAA
GATCAATAATGAAAAATGA->ATCAATAATGAAAAATGAC
CCGTCCCGACCGCATTTGA->CGTCCCGACCGCATTTGAA
ACTTCGGTTGCTGGAGGAC->CTTCGGTTGCTGGAGGACA
CCCGGCGTTGGGTATGCGT->CCGGCGTTGGGTATGCGTT
CAGGGGTGCATCAACAGTC->AGGGGTGCATCAACAGTCT
AGTTCCATAGATATTGATC->GTTCCATAGATATTGATCG
TCCCTCTCGGCATTGAGAC->CCCTCTCGGCATTGAGACT
GTCTTGCGCTCTTGTATAC->TCTTGCGCTCTTGTATACT
TAGCAGGATTCGGCTTGAC->AGCAGGATTCGGCTTGACA
GACGGATCGCCGGCTCGAG->ACGGATCGCCGGCTCGAGA
TACGTTCCAAGCCCCCGTA->ACGTTCCAAGCCCCCGTAT
TCAAGGGAACCTAATGGGA->CAAGGGAACCTAATGGGAA
GTAACCTTCGATGCTGTAT->TAACCTTCGATGCTGTATA
TCTATCAAACAATTAGGAG->CTATCAAACAATTAGGAGA
TGGCCGCCTGAATGCCGTT->GGCCGCCTGAATGCCGTTT
TACTCCTTTTGTACGCTAC->ACTCCTTTTGTACGCTACA
TATCAAACAATTAGGAGAC->ATCAAACAATTAGGAGACG
ACTTCGTGTCCTTGCAACA->CTTCGTGTCCTTGCAACAC
AGCACGATACGGTAAGTCT->GCACGATACGGTAAGTCTA
CGCCAGCATCGGGCGTTGC->GCCAGCATCGGGCGTTGCC
TCAGGCTGCGCCTGGTAAT->CAGGCTGCGCCTGGTAATT
AAGAATACTTGTTAACTAA->AGAATACTTGTTAACTAAC
ACGGCAAGCGAAACCACTC->CGGCAAGCGAAACCACTCG
TGGAATGTAGGGTCCGCCA->GGAATGTAGGGTCCGCCAT
ATCTCCTGGGTGCGTAATT->TCTCCTGGGTGCGTAATTG
CAAAACCCTGTAGCACAAA->AAAACCCTGTAGCACAAAC
TCCCGTTATGGAATGTAGG->CCCGTTATGGAATGTAGGG
AGGTCACAGCCAGGGGTGC->GGTCACAGCCAGGGGTGCA
ATTTCGCAAAGGGTGATCA->TTTCGCAAAGGGTGATCAA
TTGTTAACTAACTCGTCGC->TGTTAACTAACTCGTCGCC
TCATCTGCTCGATCGTTTC->CATCTGCTCGATCGTTTCG
CAAGGTCACAGCCAGGGGT->AAGGTCACAGCCAGGGGTG
CATTGGGCGAATGGACATT->ATTGGGCGAATGGACATTG
CAAGAACCCCCCGTGGTCT->AAGAACCCCCCGTGGTCTT
GCAGTGTAGGCATACGCCC->CAGTGTAGGCATACGCCCC
AGACCTACACGAGGACATA->GACCTACACGAGGACATAG
ATCAACAGTCTTGTCGGGT->TCAACAGTCTTGTCGGGTC
AGCACAAACGATAACGGCA->GCACAAACGATAACGGCAG
TGCTGCGCAGAGTTCGAAC->GCTGCGCAGAGTTCGAACC
TTCCATAGATATTGATCGT->TCCATAGATATTGATCGTG
TCTGTCTCACGAACGCCGT->CTGTCTCACGAACGCCGTC
TATCAAGGGAACCTAATGG->ATCAAGGGAACCTAATGGG
CCTCTCCACCGAGCCGTAT->CTCTCCACCGAGCCGTATT
GCCAGGGGTGCATCAACAG->CCAGGGGTGCATCAACAGT
AGCGCGTCGATGGACATTG->GCGCGTCGATGGACATTGC
TTCCGGTCTCCCGTTATGG->TCCGGTCTCCCGTTATGGA
TTCATTCATCTGCTCGATC->TCATTCATCTGCTCGATCG
CGGCAAGCGAAACCACTCG->GGCAAGCGAAACCACTCGA
ACCTGTTAGTTGCTGCGCA->CCTGTTAGTTGCTGCGCAG
AGATCTAGCATGTCCATCC->GATCTAGCATGTCCATCCT
GCTGTGGCATTTTAATTTA->CTGTGGCATTTTAATTTAG
AACCTCAAGAACCCCCCGT->ACCTCAAGAACCCCCCGTG
GTATTGAGTTGTGCTGCAA->TATTGAGTTGTGCTGCAAA
CTAAAGTGGCCGCCTGAAT->TAAAGTGGCCGCCTGAATG
ATTAGGAGACGGTCCTGAT->TTAGGAGACGGTCCTGATC
GATGGACATTGCATCATCA->ATGGACATTGCATCATCAC
TTACTTCGGTTGCTGGAGG->TACTTCGGTTGCTGGAGGA
CAGATTTCATTCATCTGCT->AGATTTCATTCATCTGCTC
GCCTTGACGGCAAGCGAAA->CCTTGACGGCAAGCGAAAC
GATTCCAATCTGTCGAAGT->ATTCCAATCTGTCGAAGTC
AACGCCGTCTCCGAGTCAG->ACGCCGTCTCCGAGTCAGC
TTTCGCAAAGGGTGATCAA->TTCGCAAAGGGTGATCAAT
CGTTCCAAGCCCCCGTATC->GTTCCAAGCCCCCGTATCG
GGAAGGAGCTAGCACGATA->GAAGGAGCTAGCACGATAC
ATTTTAAAGCGACTCGTCA->TTTTAAAGCGACTCGTCAG
GGGTGATCAATAATGAAAA->GGTGATCAATAATGAAAAA
CGTATTTGCAGTAAGATTA->GTATTTGCAGTAAGATTAT
GATGACTGCTGGAATCCTG->ATGACTGCTGGAATCCTGC
TCACTCATGGCCTTGACGG->CACTCATGGCCTTGACGGC
AACTAACACACGGATTGAG->ACTAACACACGGATTGAGG
CAATAATGAAAAATGACGA->AATAATGAAAAATGACGAG
TAGATATTGATCGTGCAAG->AGATATTGATCGTGCAAGG
CCTTGCCCTCACAGTGCGC->CTTGCCCTCACAGTGCGCC
TTAATTTAGCCATAACGCA->TAATTTAGCCATAACGCAC
CTCAGAACCTCAAGAACCC->TCAGAACCTCAAGAACCCC
ATACAGCCAGAAGAACAAC->TACAGCCAGAAGAACAACG
GGCAGTGTAGGCATACGCC->GCAGTGTAGGCATACGCCC
GGGAAACGATGCGTGGTCT->GGAAACGATGCGTGGTCTT
AGAACAAAGCCCGCCCCCG->GAACAAAGCCCGCCCCCGG
GTCTGCCGCATTCAGCGGC->TCTGCCGCATTCAGCGGCG
ATTATTGTCCCTTTGGTAA->TTATTGTCCCTTTGGTAAC
GTAGTGTCTTAGCATTGCC->TAGTGTCTTAGCATTGCCG
CCTACCGAGCTAAGTCTCC->CTACCGAGCTAAGTCTCCT
TCGTCCATGGCCTGAACAC->CGTCCATGGCCTGAACACG
ATGCCTACTCCTTTTGTAC->TGCCTACTCCTTTTGTACG
TGTATTGATCTCCTGGGTG->GTATTGATCTCCTGGGTGC
GACATTTAGTCTCGACCGC->ACATTTAGTCTCGACCGCA
CAGACACGTCGCCCTCCTA->AGACACGTCGCCCTCCTAC
CCATTTCGCAAAGGGTGAT->CATTTCGCAAAGGGTGATC
TCGATCGTTTCGCCTCTCA->CGATCGTTTCGCCTCTCAA
TTGTCTGCCGCATTCAGCG->TGTCTGCCGCATTCAGCGG
CGGCTTGACAGATTTCATT->GGCTTGACAGATTTCATTC
CTCGCGGGAGTGTTAGCAT->TCGCGGGAGTGTTAGCATA
GTGTGCTTTCTACTACCAT->TGTGCTTTCTACTACCATT
TGAGTAAGAATACTTGTTA->GAGTAAGAATACTTGTTAA
AGCTCAGAACCTCAAGAAC->GCTCAGAACCTCAAGAACC
TATCAGATATGCCCGACCA->ATCAGATATGCCCGACCAT
ATCGCTGAGGAATACTTGT->TCGCTGAGGAATACTTGTT
CGAAGACCTACACGAGGAC->GAAGACCTACACGAGGACA
GCCATAACGCACGCTCTTG->CCATAACGCACGCTCTTGT
GCCGCCTGAATGCCGTTTG->CCGCCTGAATGCCGTTTGT
CGATCAGAAAGAGGCAGTG->GATCAGAAAGAGGCAGTGT
TTTACTTCGGTTGCTGGAG->TTACTTCGGTTGCTGGAGG
AGCATTGCCGTCCCGACCG->GCATTGCCGTCCCGACCGC
TGACGGCAAGCGAAACCAC->GACGGCAAGCGAAACCACT
CCATCCTACGCCCTCTCCA->CATCCTACGCCCTCTCCAC
CACGAGGACATAGTGTGGT->ACGAGGACATAGTGTGGTG
CGTCTAGTCTTGGACGACG->GTCTAGTCTTGGACGACGG
TTTAATTTAGCCATAACGC->TTAATTTAGCCATAACGCA
TAAGTCTCCTTTATCAGAT->AAGTCTCCTTTATCAGATA
TGGAAAAGAGGGAGATCTA->GGAAAAGAGGGAGATCTAG
TATAGACTTCGTGTCCTTG->ATAGACTTCGTGTCCTTGC
GCGCCTGGTAATTATTGTC->CGCCTGGTAATTATTGTCC
ATTTGAAGGGTCGCTGGAA->TTTGAAGGGTCGCTGGAAG
TATTGATCTCCTGGGTGCG->ATTGATCTCCTGGGTGCGT
CGCCGGCTCGAGAACTCAC->GCCGGCTCGAGAACTCACG
TCTGCAGCATAACCCTGCT->CTGCAGCATAACCCTGCTG
TCGCCCTCCTACCGAGCTA->CGCCCTCCTACCGAGCTAA
AAGCGAAACCACTCGAAGG->AGCGAAACCACTCGAAGGC
AGGGAGATCTAGCATGTCC->GGGAGATCTAGCATGTCCA
AGATCTTTATGTTCGTGTG->GATCTTTATGTTCGTGTGC
ATATATGCCTACTCCTTTT->TATATGCCTACTCCTTTTG
ACTCAACCGTCTAGTCTTG->CTCAACCGTCTAGTCTTGG
TTAACTAACACACGGATTG->TAACTAACACACGGATTGA
TAATCCAAAACCCTGTAGC->AATCCAAAACCCTGTAGCA
GTCAGTTCCATAGATATTG->TCAGTTCCATAGATATTGA
TGCTGGAATCCTGCATATG->GCTGGAATCCTGCATATGG
AGGGTCGCTGGAAGGAGCT->GGGTCGCTGGAAGGAGCTA
GTAAGATTATTACCGACCG->TAAGATTATTACCGACCGT
AGGGTGATCAATAATGAAA->GGGTGATCAATAATGAAAA
CAGCCAGAAGAACAACGTT->AGCCAGAAGAACAACGTTC
CCTGTGGTTTGAGTCGTCG->CTGTGGTTTGAGTCGTCGA
TGCTCGTATATACTCAACC->GCTCGTATATACTCAACCG
AGCATTAGCACTCGCGGGA->GCATTAGCACTCGCGGGAG
CCCGTCTGGCCTTGCCCTC->CCGTCTGGCCTTGCCCTCA
AGTGGCCGCCTGAATGCCG->GTGGCCGCCTGAATGCCGT
GGCGAGTCGTCCATGGCCT->GCGAGTCGTCCATGGCCTG
GACGGTCCTGATCTATTGT->ACGGTCCTGATCTATTGTA
CTTTGGTAACCTTCGATGC->TTTGGTAACCTTCGATGCT
CATGTCCATCCTACGCCCT->ATGTCCATCCTACGCCCTC
GGCTTTTATTTCTGAATTG->GCTTTTATTTCTGAATTGT
ACATTGGGCGAATGGACAT->CATTGGGCGAATGGACATT
AGGGAAACGATGCGTGGTC->GGGAAACGATGCGTGGTCT
GCCGGCTCGAGAACTCACG->CCGGCTCGAGAACTCACGA
CCTGGTAATTATTGTCCCT->CTGGTAATTATTGTCCCTT
GCATCTGTTCCATGGAAGT->CATCTGTTCCATGGAAGTC
TCACGAACGCCGTCTCCGA->CACGAACGCCGTCTCCGAG
GGCAGAGCGTATTTGCAGT->GCAGAGCGTATTTGCAGTA
TCTCACGAACGCCGTCTCC->CTCACGAACGCCGTCTCCG
GTTGCACCCTAACCTGTTA->TTGCACCCTAACCTGTTAG
GTTGTGCTGCAAACGGGTA->TTGTGCTGCAAACGGGTAC
CGCATTCAGCGGCGTCCGC->GCATTCAGCGGCGTCCGCG
CCCCTCGGGCATAGCAGGA->CCCTCGGGCATAGCAGGAT
TCTTGGACGACGGATCGCC->CTTGGACGACGGATCGCCG
AAACGAATACTTGTTAACT->AACGAATACTTGTTAACTA
ACCGCATTTGAATTCCTCG->CCGCATTTGAATTCCTCGT
ATTTCTGAATTGTCTGCCG->TTTCTGAATTGTCTGCCGC
AATCTTTGCTCCCCTCGGG->ATCTTTGCTCCCCTCGGGC
CAGTTCCATAGATATTGAT->AGTTCCATAGATATTGATC
TTCAGCGGCGTCCGCGAGT->TCAGCGGCGTCCGCGAGTT
GAGCTAAGTCTCCTTTATC->AGCTAAGTCTCCTTTATCA
AACGGGTACAAACCGAGAC->ACGGGTACAAACCGAGACC
GCATTTTAAAGGAGCAAGT->CATTTTAAAGGAGCAAGTC
GAGATCTAGCATGTCCATC->AGATCTAGCATGTCCATCC
AGTGGCGTACATGCCCATC->GTGGCGTACATGCCCATCG
AATACTTGTTAACTAACAC->ATACTTGTTAACTAACACA
AAAACCCTGTAGCACAAAC->AAACCCTGTAGCACAAACG
AGATTTCATTCATCTGCTC->GATTTCATTCATCTGCTCG
TTGTGTAAACGAATACTTG->TGTGTAAACGAATACTTGT
GTAAGAATACTTGTTAACT->TAAGAATACTTGTTAACTA
AGTATCTTCGGCCACAAAT->GTATCTTCGGCCACAAATA
GTCTCGACCGCAGAACTGA->TCTCGACCGCAGAACTGAG
TTGCAACACAAGTGTTGCA->TGCAACACAAGTGTTGCAC
TGCCGCATTCAGCGGCGTC->GCCGCATTCAGCGGCGTCC
AGTTAGCCGAATTGTACCT->GTTAGCCGAATTGTACCTT
ACGGGTACAAACCGAGACC->CGGGTACAAACCGAGACCA
CTCGACCGCAGAACTGAGT->TCGACCGCAGAACTGAGTA
TCCTGCATATGGAGGGGCG->CCTGCATATGGAGGGGCGC
TGGACATTGCATCATCACT->GGACATTGCATCATCACTC
CGCCCCAGCGCGTCGATGG->GCCCCAGCGCGTCGATGGA
GGATTTGAAGGGTCGCTGG->GATTTGAAGGGTCGCTGGA
CAGCATCGGGCGTTGCCTG->AGCATCGGGCGTTGCCTGA
GGATTGAGGCAGCTGTGGC->GATTGAGGCAGCTGTGGCA
CCGCAGAACTGAGTAAACA->CGCAGAACTGAGTAAACAG
CACAAACGATAACGGCAGA->ACAAACGATAACGGCAGAC
TTCATCTGCTCGATCGTTT->TCATCTGCTCGATCGTTTC
CCCCCGTGGTCTTTACTTC->CCCCGTGGTCTTTACTTCG
ATATGGAGGGGCGCAGTGT->TATGGAGGGGCGCAGTGTG
AGTGTGAGTAAGAATACTT->GTGTGAGTAAGAATACTTG
GTGCTACCCCATTAAACCC->TGCTACCCCATTAAACCCG
GATTTCATTCATCTGCTCG->ATTTCATTCATCTGCTCGA
GATCTCCTGGGTGCGTAAT->ATCTCCTGGGTGCGTAATT
GCTCCCCTCGGGCATAGCA->CTCCCCTCGGGCATAGCAG
ATCTGTTCCATGGAAGTCC->TCTGTTCCATGGAAGTCCT
AAAATGACGAGGCGTGTAT->AAATGACGAGGCGTGTATC
GGGCATAGCAGGATTCGGC->GGCATAGCAGGATTCGGCT
CAGGATGGCATGGGCTATA->AGGATGGCATGGGCTATAT
TGCATCAACAGTCTTGTCG->GCATCAACAGTCTTGTCGG
CAAGTCAATTACCGTCAGA->AAGTCAATTACCGTCAGAA
TATGGAGGGGCGCAGTGTG->ATGGAGGGGCGCAGTGTGC
CACTCGCGGGAGTGTTAGC->ACTCGCGGGAGTGTTAGCA
GAGCCGTATTGAGTTGTGC->AGCCGTATTGAGTTGTGCT
TTGTTAACTAACACACGGA->TGTTAACTAACACACGGAT
CAAAGGGTGATCAATAATG->AAAGGGTGATCAATAATGA
TGGGCTATATACAAAGTAT->GGGCTATATACAAAGTATC
GGACATTTAGTCTCGACCG->GACATTTAGTCTCGACCGC
TGCGCCTGGTAATTATTGT->GCGCCTGGTAATTATTGTC
TGTGGCATTTTAAAGGAGC->GTGGCATTTTAAAGGAGCA
GCATTGAGACTATAGACTT->CATTGAGACTATAGACTTC
GCCGTTTGTACCTCGCTTT->CCGTTTGTACCTCGCTTTA
ACTAACATACTAAAGTGGC->CTAACATACTAAAGTGGCC
GGTACAAACCGAGACCACT->GTACAAACCGAGACCACTC
GGGGCGCAGTGTGCTTTCT->GGGCGCAGTGTGCTTTCTA
GAAAAATGACGAGGCGTGT->AAAAATGACGAGGCGTGTA
CTGGAATCCTGCATATGGA->TGGAATCCTGCATATGGAG
ATTGTCCCTTTGGTAACCT->TTGTCCCTTTGGTAACCTT
AAATGTATTGATCTCCTGG->AATGTATTGATCTCCTGGG
CATCAACAGTCTTGTCGGG->ATCAACAGTCTTGTCGGGT
CCTGGGTGCGTAATTGAGG->CTGGGTGCGTAATTGAGGA
TCCACCGAGCCGTATTGAG->CCACCGAGCCGTATTGAGT
TTCCTCGTTCAACTATACG->TCCTCGTTCAACTATACGA
ACTCATGGCCTTGACGGCA->CTCATGGCCTTGACGGCAA
CGAGCTAAGTCTCCTTTAT->GAGCTAAGTCTCCTTTATC
CTAAGGCAGCTGTGGCATT->TAAGGCAGCTGTGGCATTT
ATAGATATTGATCGTGCAA->TAGATATTGATCGTGCAAG
CGACCATCCCTCTCGGCAT->GACCATCCCTCTCGGCATT
AGCGGCGTCCGCGAGTTAG->GCGGCGTCCGCGAGTTAGC
TGTGGCATTTTAAGTGGGA->GTGGCATTTTAAGTGGGAG
CTACCATTTCGCAAAGGGT->TACCATTTCGCAAAGGGTG
GTTGTGGGCTTTTATTTCT->TTGTGGGCTTTTATTTCTG
CTATTGTAATGGGTCAGAT->TATTGTAATGGGTCAGATT
ATGAAAAATGACGAGGCGT->TGAAAAATGACGAGGCGTG
ACTTGTTAACTAACCTCGA->CTTGTTAACTAACCTCGAC
AATGGACATTGTAGGGAGT->ATGGACATTGTAGGGAGTC
GACTTCGTGTCCTTGCAAC->ACTTCGTGTCCTTGCAACA
CCAGCATCGGGCGTTGCCT->CAGCATCGGGCGTTGCCTG
CCTCGTTCAACTATACGAT->CTCGTTCAACTATACGATG
CGCAGAGTTCGAACCGGTA->GCAGAGTTCGAACCGGTAC
CGAGAACTCACGAGTCTAC->GAGAACTCACGAGTCTACA
TATGCCCGACCATCCCTCT->ATGCCCGACCATCCCTCTC
TACAGGGCGCGTTCGTTCT->ACAGGGCGCGTTCGTTCTC
CCGAGCTAAGTCTCCTTTA->CGAGCTAAGTCTCCTTTAT
CTGCAAACGGGTACAAACC->TGCAAACGGGTACAAACCG
GATGCATCTGTTCCATGGA->ATGCATCTGTTCCATGGAA
AGCGACTCGTCAGTTCCAT->GCGACTCGTCAGTTCCATA
ATACCGCCAGCATCGGGCG->TACCGCCAGCATCGGGCGT
CACGAACGCCGTCTCCGAG->ACGAACGCCGTCTCCGAGT
ATTTAGTCTCGACCGCAGA->TTTAGTCTCGACCGCAGAA
CCACCGAGCCGTATTGAGT->CACCGAGCCGTATTGAGTT
GGTGATCAATAATGAAAAA->GTGATCAATAATGAAAAAT
GTCGTCGACTCGCATTCTG->TCGTCGACTCGCATTCTGC
GCATTCTGCTCGTATATAC->CATTCTGCTCGTATATACT
GTGGCATTTTAATTTAGCC->TGGCATTTTAATTTAGCCA
GAACTGAGTAAACAGGATG->AACTGAGTAAACAGGATGG
GCATTTTAAAGCGACTCGT->CATTTTAAAGCGACTCGTC
GAACAAAGCCCGCCCCCGG->AACAAAGCCCGCCCCCGGC
CGCCCTCCTACCGAGCTAA->GCCCTCCTACCGAGCTAAG
AGATTATTACCGACCGTGC->GATTATTACCGACCGTGCT
CCTCGACGCTAAGGCAGCT->CTCGACGCTAAGGCAGCTG
TACTTGTTAACTAACCTCG->ACTTGTTAACTAACCTCGA
ACGAGGCGTGTATCAAGGG->CGAGGCGTGTATCAAGGGA
AGACGGTCCTGATCTATTG->GACGGTCCTGATCTATTGT
TACTCAACCGTCTAGTCTT->ACTCAACCGTCTAGTCTTG
AACGATGCAGCAGCGGCAG->ACGATGCAGCAGCGGCAGC
GGTATGCGTTGCGCGTCTG->GTATGCGTTGCGCGTCTGT
GAAAGAGGCAGTGTAGGCA->AAAGAGGCAGTGTAGGCAT
CCCGTCCGCAGACACGTCG->CCGTCCGCAGACACGTCGC
TATTGATCGTGCAAGGTCA->ATTGATCGTGCAAGGTCAC
TTGTTAACTAACCTCGACG->TGTTAACTAACCTCGACGC
AGTCTTGGACGACGGATCG->GTCTTGGACGACGGATCGC
ACGATGACTGCTGGAATCC->CGATGACTGCTGGAATCCT
AGTCGGCAGAGCGTATTTG->GTCGGCAGAGCGTATTTGC
TTGGTAACCTTCGATGCTG->TGGTAACCTTCGATGCTGT
GACGAGGCGTGTATCAAGG->ACGAGGCGTGTATCAAGGG
GCATTCAGCGGCGTCCGCG->CATTCAGCGGCGTCCGCGA
AACCTTCGATGCTGTATAA->ACCTTCGATGCTGTATAAA
TAACTAACTCGTCGCCGTA->AACTAACTCGTCGCCGTAG
GACCGCATTTGAATTCCTC->ACCGCATTTGAATTCCTCG
GCTACCCCATTAAACCCGT->CTACCCCATTAAACCCGTC
CTGTCGAAGTCGGCAGAGC->TGTCGAAGTCGGCAGAGCG
AGACCACTCTGCAGCATAA->GACCACTCTGCAGCATAAC
AGGCGAGTCGTCCATGGCC->GGCGAGTCGTCCATGGCCT
GAGGGGCGCAGTGTGCTTT->AGGGGCGCAGTGTGCTTTC
GTCTTTACTTCGGTTGCTG->TCTTTACTTCGGTTGCTGG
AAGGGTGATCAATAATGAA->AGGGTGATCAATAATGAAA
GAGAAACACCCCGTCCGCA->AGAAACACCCCGTCCGCAG
CTCGTTCAACTATACGATG->TCGTTCAACTATACGATGA
GTTAGCCGAATTGTACCTT->TTAGCCGAATTGTACCTTG
GATCTTTATGTTCGTGTGC->ATCTTTATGTTCGTGTGCC
GTCCGCAGACACGTCGCCC->TCCGCAGACACGTCGCCCT
TCTCCCGTTATGGAATGTA->CTCCCGTTATGGAATGTAG
TAAGTACGTTCCAAGCCCC->AAGTACGTTCCAAGCCCCC
TGGGTATGCGTTGCGCGTC->GGGTATGCGTTGCGCGTCT
GAACGCCGTCTCCGAGTCA->AACGCCGTCTCCGAGTCAG
ATCTTCGGCCACAAATACG->TCTTCGGCCACAAATACGG
TTAGCATTGCCGTCCCGAC->TAGCATTGCCGTCCCGACC
CCGAGTCAGCTATTCATGA->CGAGTCAGCTATTCATGAA
CACAGCCAGGGGTGCATCA->ACAGCCAGGGGTGCATCAA
ACCCTGTAGCACAAACGAT->CCCTGTAGCACAAACGATA
GGGCTTTTATTTCTGAATT->GGCTTTTATTTCTGAATTG
ATGCCGTTTGTACCTCGCT->TGCCGTTTGTACCTCGCTT
TGGAATCCTGCATATGGAG->GGAATCCTGCATATGGAGG
CCTGAATCTTTGCTCCCCT->CTGAATCTTTGCTCCCCTC
TCTTGTGTAAACGAATACT->CTTGTGTAAACGAATACTT
GCATCATCACTCATGGCCT->CATCATCACTCATGGCCTT
GAATCTTTGCTCCCCTCGG->AATCTTTGCTCCCCTCGGG
TTAAAGCGACTCGTCAGTT->TAAAGCGACTCGTCAGTTC
ACTAACTCGTCGCCGTAGG->CTAACTCGTCGCCGTAGGC
CGACCGCATTTGAATTCCT->GACCGCATTTGAATTCCTC
CCTGTAGCACAAACGATAA->CTGTAGCACAAACGATAAC
ATTACCGTCAGAAGGCTCC->TTACCGTCAGAAGGCTCCT
CGTGGTCTTTACTTCGGTT->GTGGTCTTTACTTCGGTTG
TGTTAACTAACCTCGACGC->GTTAACTAACCTCGACGCT
CGCGAGTTAGCCGAATTGT->GCGAGTTAGCCGAATTGTA
GCACTCGCGGGAGTGTTAG->CACTCGCGGGAGTGTTAGC
ACTCGTCAGTTCCATAGAT->CTCGTCAGTTCCATAGATA
TCAATAATGAAAAATGACG->CAATAATGAAAAATGACGA
GAGTCTACATTGGGCGAAT->AGTCTACATTGGGCGAATG
ACAACGTTCGATCAGAAAG->CAACGTTCGATCAGAAAGA
GAACCGGTACATTTGCCGA->AACCGGTACATTTGCCGAG
AGCCGTATTGAGTTGTGCT->GCCGTATTGAGTTGTGCTG
TTATTACCGACCGTGCTAC->TATTACCGACCGTGCTACC
GTCTCCTTTATCAGATATG->TCTCCTTTATCAGATATGC
CTCACGAGTCTACATTGGG->TCACGAGTCTACATTGGGC
CAGAACAAAGCCCGCCCCC->AGAACAAAGCCCGCCCCCG
GAAACACCCCGTCCGCAGA->AAACACCCCGTCCGCAGAC
GCTTTATAAAGGGAAACGA->CTTTATAAAGGGAAACGAT
CATTTTAAAGGAGCAAGTC->ATTTTAAAGGAGCAAGTCA
GCGCCGTCTCGATGCATCT->CGCCGTCTCGATGCATCTG
CAGGCTGCGCCTGGTAATT->AGGCTGCGCCTGGTAATTA
ACAAAGTATCTTCGGCCAC->CAAAGTATCTTCGGCCACA
GGGTCCGCCATGAGCTTGA->GGTCCGCCATGAGCTTGAT
AAGCCCCCGTATCGGCATC->AGCCCCCGTATCGGCATCA
GGCGCAGTGTGCTTTCTAC->GCGCAGTGTGCTTTCTACT
TTGTTAACTAACGATGCAG->TGTTAACTAACGATGCAGC
ACTCGTCGCCGTAGGCAGC->CTCGTCGCCGTAGGCAGCT
TAATGGGAATATATATGCC->AATGGGAATATATATGCCT
CTCTCAAATGTATTGATCT->TCTCAAATGTATTGATCTC
AGCCATAACGCACGCTCTT->GCCATAACGCACGCTCTTG
CAAGCCCCCGTATCGGCAT->AAGCCCCCGTATCGGCATC
ATTATTACCGACCGTGCTA->TTATTACCGACCGTGCTAC
TTAACTAACTCGTCGCCGT->TAACTAACTCGTCGCCGTA
CGTCCGCGAGTTAGCCGAA->GTCCGCGAGTTAGCCGAAT
GTCCATCCTACGCCCTCTC->TCCATCCTACGCCCTCTCC
GGTCTATAAGTACGTTCCA->GTCTATAAGTACGTTCCAA
CGTCCATGGCCTGAACACG->GTCCATGGCCTGAACACGA
GTTCGAACCGGTACATTTG->TTCGAACCGGTACATTTGC
CGATCGTTTCGCCTCTCAA->GATCGTTTCGCCTCTCAAA
AGGAGCTAGCACGATACGG->GGAGCTAGCACGATACGGT
TCGATCAGAAAGAGGCAGT->CGATCAGAAAGAGGCAGTG
GAACCTAATGGGAATATAT->AACCTAATGGGAATATATA
GGTTGCTGGAGGACATTTA->GTTGCTGGAGGACATTTAG
GCCGTATTGAGTTGTGCTG->CCGTATTGAGTTGTGCTGC
CTGCTCGTATATACTCAAC->TGCTCGTATATACTCAACC
AGTGCGCCGTCTCGATGCA->GTGCGCCGTCTCGATGCAT
TATGGAATGTAGGGTCCGC->ATGGAATGTAGGGTCCGCC
TAACGATGCAGCAGCGGCA->AACGATGCAGCAGCGGCAG
GCGCGTCTGTCTCACGAAC->CGCGTCTGTCTCACGAACG
GTCGAAGTCGGCAGAGCGT->TCGAAGTCGGCAGAGCGTA
CGTTGGGTATGCGTTGCGC->GTTGGGTATGCGTTGCGCG
AGGGAGTCAACGAGTGGCG->GGGAGTCAACGAGTGGCGT
GTCGTCCATGGCCTGAACA->TCGTCCATGGCCTGAACAC
TTAACTAACGATGCAGCAG->TAACTAACGATGCAGCAGC
TTCGGCTTGACAGATTTCA->TCGGCTTGACAGATTTCAT
CGAGTTAGCCGAATTGTAC->GAGTTAGCCGAATTGTACC
TCTTTACTTCGGTTGCTGG->CTTTACTTCGGTTGCTGGA
GACTATAGACTTCGTGTCC->ACTATAGACTTCGTGTCCT
TCGCCGTAGGCAGCTGTGG->CGCCGTAGGCAGCTGTGGC
ATTCCAATCTGTCGAAGTC->TTCCAATCTGTCGAAGTCG
TGTAGCACAAACGATAACG->GTAGCACAAACGATAACGG
GAAGTCCTTAATCCAAAAC->AAGTCCTTAATCCAAAACC
CTACAGCATTAGCACTCGC->TACAGCATTAGCACTCGCG
TCAATTACCGTCAGAAGGC->CAATTACCGTCAGAAGGCT
TAGCCATAACGCACGCTCT->AGCCATAACGCACGCTCTT
TTGCACCCTAACCTGTTAG->TGCACCCTAACCTGTTAGT
TAGCATTGCCGTCCCGACC->AGCATTGCCGTCCCGACCG
AACAGTCTTGTCGGGTCTA->ACAGTCTTGTCGGGTCTAT
CCAGGGGTGCATCAACAGT->CAGGGGTGCATCAACAGTC
GCATATGGAGGGGCGCAGT->CATATGGAGGGGCGCAGTG
CATCTGTTCCATGGAAGTC->ATCTGTTCCATGGAAGTCC
CTCCCCTCGGGCATAGCAG->TCCCCTCGGGCATAGCAGG
GAGGAATACTTGTTAACTA->AGGAATACTTGTTAACTAA
TCTCCTGGGTGCGTAATTG->CTCCTGGGTGCGTAATTGA
TCGCAAAGGGTGATCAATA->CGCAAAGGGTGATCAATAA
TCTTGTATACTGTGTCGCG->CTTGTATACTGTGTCGCGC
TGTAGGGTCCGCCATGAGC->GTAGGGTCCGCCATGAGCT
TAAGTGGGAGCACTACAGC->AAGTGGGAGCACTACAGCA
ACAGCATTAGCACTCGCGG->CAGCATTAGCACTCGCGGG
CAAAGCGTACCTGTGGTTT->AAAGCGTACCTGTGGTTTG
TTAGCCGAATTGTACCTTG->TAGCCGAATTGTACCTTGT
CCTGCATATGGAGGGGCGC->CTGCATATGGAGGGGCGCA
ACGAGTGGCGTACATGCCC->CGAGTGGCGTACATGCCCA
GATACGGTAAGTCTATCAA->ATACGGTAAGTCTATCAAA
CCTTTTGTACGCTACAGGG->CTTTTGTACGCTACAGGGC
ATACTAAAGTGGCCGCCTG->TACTAAAGTGGCCGCCTGA
GTAGGCATACGCCCCAGCG->TAGGCATACGCCCCAGCGC
TGCAGTAAGATTATTACCG->GCAGTAAGATTATTACCGA
AGGGGTGCATCAACAGTCT->GGGGTGCATCAACAGTCTT
CCCTCGGGCATAGCAGGAT->CCTCGGGCATAGCAGGATT
AGTGTGCTTTCTACTACCA->GTGTGCTTTCTACTACCAT
CATGGCCTGAACACGAAGA->ATGGCCTGAACACGAAGAC
GCTTGACAGATTTCATTCA->CTTGACAGATTTCATTCAT
TGCTTTCTACTACCATTTC->GCTTTCTACTACCATTTCG
TGCAGCATAACCCTGCTGC->GCAGCATAACCCTGCTGCT
GCATCGGGCGTTGCCTGAA->CATCGGGCGTTGCCTGAAT
CTGTGGCATTTTAATTTAG->TGTGGCATTTTAATTTAGC
TAGCCGAATTGTACCTTGT->AGCCGAATTGTACCTTGTA
AGACTTCGTGTCCTTGCAA->GACTTCGTGTCCTTGCAAC
TCGGCATTGAGACTATAGA->CGGCATTGAGACTATAGAC
CCGCCAGCATCGGGCGTTG->CGCCAGCATCGGGCGTTGC
GGGCGAATGGACATTGTAG->GGCGAATGGACATTGTAGG
GTGGCCGCCTGAATGCCGT->TGGCCGCCTGAATGCCGTT
GTCTCACGAACGCCGTCTC->TCTCACGAACGCCGTCTCC
AGTCTCGACCGCAGAACTG->GTCTCGACCGCAGAACTGA
CCTAATGGGAATATATATG->CTAATGGGAATATATATGC
GTTAACTAACCTCGACGCT->TTAACTAACCTCGACGCTA
CTGCTGCTTCGTTGTGGGC->TGCTGCTTCGTTGTGGGCT
TACATGCCCATCGCTGAGG->ACATGCCCATCGCTGAGGA
CCCGTTATGGAATGTAGGG->CCGTTATGGAATGTAGGGT
GTGGTCTTGCGCTCTTGTA->TGGTCTTGCGCTCTTGTAT
GGATGGCATGGGCTATATA->GATGGCATGGGCTATATAC
ACAGGATGGCATGGGCTAT->CAGGATGGCATGGGCTATA
TCCGAGTCAGCTATTCATG->CCGAGTCAGCTATTCATGA
CATGGCCTTGACGGCAAGC->ATGGCCTTGACGGCAAGCG
TCGCTTTATAAAGGGAAAC->CGCTTTATAAAGGGAAACG
GTCTCCGAGTCAGCTATTC->TCTCCGAGTCAGCTATTCA
TGTAGTGTCTTAGCATTGC->GTAGTGTCTTAGCATTGCC
ATGTAGGGTCCGCCATGAG->TGTAGGGTCCGCCATGAGC
ACAGATTTCATTCATCTGC->CAGATTTCATTCATCTGCT
TCAACAGTCTTGTCGGGTC->CAACAGTCTTGTCGGGTCT
ATGGCCTTGACGGCAAGCG->TGGCCTTGACGGCAAGCGA
GTACGTTCCAAGCCCCCGT->TACGTTCCAAGCCCCCGTA
ATTTAGCCATAACGCACGC->TTTAGCCATAACGCACGCT
GTCTGGCCTTGCCCTCACA->TCTGGCCTTGCCCTCACAG
CATTCAGCGGCGTCCGCGA->ATTCAGCGGCGTCCGCGAG
AAAAGAGGGAGATCTAGCA->AAAGAGGGAGATCTAGCAT
TTTGCCGAGTGTGAGTAAG->TTGCCGAGTGTGAGTAAGA
TTGATTCCAATCTGTCGAA->TGATTCCAATCTGTCGAAG
ATTTGCAGTAAGATTATTA->TTTGCAGTAAGATTATTAC
TAACACACGGATTGAGGCA->AACACACGGATTGAGGCAG
CTGTGGCATTTTAAAGCGA->TGTGGCATTTTAAAGCGAC
AGTCCTTAATCCAAAACCC->GTCCTTAATCCAAAACCCT
TACCTTGTAGTGTCTTAGC->ACCTTGTAGTGTCTTAGCA
CAGAGCGTATTTGCAGTAA->AGAGCGTATTTGCAGTAAG
AAGAACAACGTTCGATCAG->AGAACAACGTTCGATCAGA
TGTGCTTTCTACTACCATT->GTGCTTTCTACTACCATTT
GTTCGATCAGAAAGAGGCA->TTCGATCAGAAAGAGGCAG
CATTTTAATTTAGCCATAA->ATTTTAATTTAGCCATAAC
CAGTGTGCTTTCTACTACC->AGTGTGCTTTCTACTACCA
TGTTAGTTGCTGCGCAGAG->GTTAGTTGCTGCGCAGAGT
CGTTGCCTGAATCTTTGCT->GTTGCCTGAATCTTTGCTC
ACCCCGTCCGCAGACACGT->CCCCGTCCGCAGACACGTC
GGTCTCCCGTTATGGAATG->GTCTCCCGTTATGGAATGT
GAATGGACATTGTAGGGAG->AATGGACATTGTAGGGAGT
TGCTTATTATACAGCCAGA->GCTTATTATACAGCCAGAA
GTCAGATTGCTTATTATAC->TCAGATTGCTTATTATACA
ATACGCCCCAGCGCGTCGA->TACGCCCCAGCGCGTCGAT
TAGGCAGCTGTGGCATTTT->AGGCAGCTGTGGCATTTTA
GGGCGTTGCCTGAATCTTT->GGCGTTGCCTGAATCTTTG
CTGCGCCTGGTAATTATTG->TGCGCCTGGTAATTATTGT
CGCGGGAGTGTTAGCATAG->GCGGGAGTGTTAGCATAGC
ACCTCGCTTTATAAAGGGA->CCTCGCTTTATAAAGGGAA
TCTATAAGTACGTTCCAAG->CTATAAGTACGTTCCAAGC
ATCATCACTCATGGCCTTG->TCATCACTCATGGCCTTGA
CGAGGACATAGTGTGGTGC->GAGGACATAGTGTGGTGCC
TTCCAAGCCCCCGTATCGG->TCCAAGCCCCCGTATCGGC
GGGCGCAGTGTGCTTTCTA->GGCGCAGTGTGCTTTCTAC
CACTCTGCAGCATAACCCT->ACTCTGCAGCATAACCCTG
CATCGCTGAGGAATACTTG->ATCGCTGAGGAATACTTGT
ATTAAACCCGTCTGGCCTT->TTAAACCCGTCTGGCCTTG
TTCGATGCTGTATAAAGAG->TCGATGCTGTATAAAGAGT
TTTCGCCTCTCAAATGTAT->TTCGCCTCTCAAATGTATT
GTGGCGTACATGCCCATCG->TGGCGTACATGCCCATCGC
GTTTGTACCTCGCTTTATA->TTTGTACCTCGCTTTATAA
GCCACAAATACGGAGAAAC->CCACAAATACGGAGAAACA
GTGCTGCAAACGGGTACAA->TGCTGCAAACGGGTACAAA
CTTGATTCCAATCTGTCGA->TTGATTCCAATCTGTCGAA
TACGCCCCAGCGCGTCGAT->ACGCCCCAGCGCGTCGATG
GTACCTCGCTTTATAAAGG->TACCTCGCTTTATAAAGGG
GCTATTCATGAATACTTGT->CTATTCATGAATACTTGTT
ATGTCCATCCTACGCCCTC->TGTCCATCCTACGCCCTCT
TAGCACGATACGGTAAGTC->AGCACGATACGGTAAGTCT
AAACCACTCGAAGGCGAGT->AACCACTCGAAGGCGAGTC
TGTACGCTACAGGGCGCGT->GTACGCTACAGGGCGCGTT
CCCGCCCCCGGCGTTGGGT->CCGCCCCCGGCGTTGGGTA
GCATTAGCACTCGCGGGAG->CATTAGCACTCGCGGGAGT
GTCTATAAGTACGTTCCAA->TCTATAAGTACGTTCCAAG
CTAACCTCGACGCTAAGGC->TAACCTCGACGCTAAGGCA
GTGGAAAAGAGGGAGATCT->TGGAAAAGAGGGAGATCTA
ACGAATACTTGTTAACTAA->CGAATACTTGTTAACTAAC
ATATGCCTACTCCTTTTGT->TATGCCTACTCCTTTTGTA
CAGAACTGAGTAAACAGGA->AGAACTGAGTAAACAGGAT
TGCGCAGAGTTCGAACCGG->GCGCAGAGTTCGAACCGGT
TACTACCATTTCGCAAAGG->ACTACCATTTCGCAAAGGG
TATACAGCCAGAAGAACAA->ATACAGCCAGAAGAACAAC
ACGTCGCCCTCCTACCGAG->CGTCGCCCTCCTACCGAGC
CCAAGCCCCCGTATCGGCA->CAAGCCCCCGTATCGGCAT
GGTTTGAGTCGTCGACTCG->GTTTGAGTCGTCGACTCGC
ATCTTTGCTCCCCTCGGGC->TCTTTGCTCCCCTCGGGCA
GACACGTCGCCCTCCTACC->ACACGTCGCCCTCCTACCG
AAAGCCCGCCCCCGGCGTT->AAGCCCGCCCCCGGCGTTG
AATTACCGTCAGAAGGCTC->ATTACCGTCAGAAGGCTCC
ACAAAGCCCGCCCCCGGCG->CAAAGCCCGCCCCCGGCGT
GAAGTCGGCAGAGCGTATT->AAGTCGGCAGAGCGTATTT
TGCTACCCCATTAAACCCG->GCTACCCCATTAAACCCGT
GACCGTGCTACCCCATTAA->ACCGTGCTACCCCATTAAA
CTAATGGGAATATATATGC->TAATGGGAATATATATGCC
AAACAGGATGGCATGGGCT->AACAGGATGGCATGGGCTA
GGGGGATTTGAAGGGTCGC->GGGGATTTGAAGGGTCGCT
ATTTCTTAGATCTTTATGT->TTTCTTAGATCTTTATGTT
TTGTGCTGCAAACGGGTAC->TGTGCTGCAAACGGGTACA
TATAAGTACGTTCCAAGCC->ATAAGTACGTTCCAAGCCC
CAGAAGAACAACGTTCGAT->AGAAGAACAACGTTCGATC
ATGAATACTTGTTAACTAA->TGAATACTTGTTAACTAAC
GTCGGCAGAGCGTATTTGC->TCGGCAGAGCGTATTTGCA
TTCTGAATTGTCTGCCGCA->TCTGAATTGTCTGCCGCAT
AGCCGAATTGTACCTTGTA->GCCGAATTGTACCTTGTAG
GAACAACGTTCGATCAGAA->AACAACGTTCGATCAGAAA
AAGTCCTTAATCCAAAACC->AGTCCTTAATCCAAAACCC
CATAGTGTGGTGCCAAAGC->ATAGTGTGGTGCCAAAGCG
TCGATGCATCTGTTCCATG->CGATGCATCTGTTCCATGG
TCGTATATACTCAACCGTC->CGTATATACTCAACCGTCT
CTGAACACGAAGACCTACA->TGAACACGAAGACCTACAC
TAACCCTGCTGCTTCGTTG->AACCCTGCTGCTTCGTTGT
ACCGGTACATTTGCCGAGT->CCGGTACATTTGCCGAGTG
TCACAGCCAGGGGTGCATC->CACAGCCAGGGGTGCATCA
CGCATTTGAATTCCTCGTT->GCATTTGAATTCCTCGTTC
TGTGAGTAAGAATACTTGT->GTGAGTAAGAATACTTGTT
CATCTGCTCGATCGTTTCG->ATCTGCTCGATCGTTTCGC
CAAATACGGAGAAACACCC->AAATACGGAGAAACACCCC
ACGCACGCTCTTGTGTAAA->CGCACGCTCTTGTGTAAAC
CGAGGCGTGTATCAAGGGA->GAGGCGTGTATCAAGGGAA
GGCATACGCCCCAGCGCGT->GCATACGCCCCAGCGCGTC
AGGCTGCGCCTGGTAATTA->GGCTGCGCCTGGTAATTAT
CAGTGTAGGCATACGCCCC->AGTGTAGGCATACGCCCCA
ACGAGTCTACATTGGGCGA->CGAGTCTACATTGGGCGAA
CCGGCTCGAGAACTCACGA->CGGCTCGAGAACTCACGAG
GCAGCTGTGGCATTTTAAG->CAGCTGTGGCATTTTAAGT
GCCTTGCCCTCACAGTGCG->CCTTGCCCTCACAGTGCGC
CGGTACATTTGCCGAGTGT->GGTACATTTGCCGAGTGTG
CAGACTAACATACTAAAGT->AGACTAACATACTAAAGTG
TGGTGCCAAAGCGTACCTG->GGTGCCAAAGCGTACCTGT
ACACACGGATTGAGGCAGC->CACACGGATTGAGGCAGCT
GCGGCAGCTGTGGCATTTT->CGGCAGCTGTGGCATTTTA
CTTGTAGTGTCTTAGCATT->TTGTAGTGTCTTAGCATTG
GGACATTGCATCATCACTC->GACATTGCATCATCACTCA
TTGCTGCGCAGAGTTCGAA->TGCTGCGCAGAGTTCGAAC
CCTTTATCAGATATGCCCG->CTTTATCAGATATGCCCGA
GTCTCGATGCATCTGTTCC->TCTCGATGCATCTGTTCCA
TTTAGTCTCGACCGCAGAA->TTAGTCTCGACCGCAGAAC
AGGCAGTGTAGGCATACGC->GGCAGTGTAGGCATACGCC
TGACTGCTGGAATCCTGCA->GACTGCTGGAATCCTGCAT
TCCTGATCTATTGTAATGG->CCTGATCTATTGTAATGGG
TGGCCTTGCCCTCACAGTG->GGCCTTGCCCTCACAGTGC
GAGGACATAGTGTGGTGCC->AGGACATAGTGTGGTGCCA
ATCTATTGTAATGGGTCAG->TCTATTGTAATGGGTCAGA
TCAAATGTATTGATCTCCT->CAAATGTATTGATCTCCTG
CATCCCTCTCGGCATTGAG->ATCCCTCTCGGCATTGAGA